45 45
#**-------------------------------------------------------------------------------------------------------------------------------------
*********-*****-*****-***********-***********-**-********-*****-*****-**************-*****-*****************-********-**-********-*****-
----**-**----**----**----**-**----**----**-**-**-**----------**----**-**-------**----**-------------**-**-------**-**-**-**----**-**----
-*****-**-*****-**-********-**-**-*****-**-**-**-***********-********-*****-********-*****-********-**-**-**-*****-***********-**-*****-
----**----**-**-**-**-**----**-**-**----**-**-**-------**----**-------**----**----**----**----**----**----**----**-**----**----------**-
-***********-*****-**-**-********-*****-**-*****-**-*****************-*****-*****-*****-********-**-*****-********-**-*****************-
----------**-------**-**----**----**-------**----**-**----------**----**-**----**----------**-**-**-**----**-------**-**----**-**-------
-*****-*****-**-**-**-*****-*****-**-*****-**-********-**************-**-**-*****-**-********-**-***********-*****-**-**-*****-********-
-**-------**-**-**-------**-------**-**-------**-**-**-**-**----**-**-------**-**-**----**----**----**-**-------**-**-**-**-------**----
-********-**-**-********-********-**************-**-**-**-**-*****-***********-**************-**-*****-***********-**-**-*****-*****-**-
-**----**-**-**-**-------**-------------------**----**----**----**-**-**-**----**----------**----**----**-**-**-**-------**----------**-
-*****-**-*****-**************-*****-**-*****-*****-**-**-**-*****-**-**-**-**-********-**-*****-*****-**-**-**-**-***********-**-*****-
-**-**----**-**----**-------------**-**----**-**-------**-**-------**-**----**-**-------**-**-**-**-------**----**-**----**----**-**----
-**-**-*****-*****************-********-***********-*****-*****-*****-**-*****************-**-**-**-**-**-**-*****-**-**-*****-********-
-**-**-**----**----**----**----**-**----**----**-**----**----------**----**-**-------------**----**-**-**-**-------**-**-**-**-**-------
-**-********-*****-**-**-********-**-********-**-*****-***********-**-*****-**-********-********-********-**-**-*****-*****-*****-*****-
----**-------**----**-**----**-**----**-------**-**-------------**-**-**----**----**-------------**-------**-**-**-------------**-**-**-
-**-**-*****-*****-********-**-*****-**-********-**-********-********-**-**-**-*****-**-**-***********-********-********-**-********-**-
-**-**----**-**-------------**-**----**----**-**----------**-------**----**-**-**-**-**-**----**-**----**-**----**----**-**-**-------**-
-********-**-**************-**-**-*****-*****-**-*****-********-*****-***********-**-********-**-**-**-**-*****-**-********-*****-*****-
----**----**-**-------**----**----**-------**----**----**-**-------**-**-------------**-**----**----**----------**----------------**-**-
-********-**-**-*****-**-********-**-**-*****-********-**-**-********-**-*****-**-**-**-***********-*****-*****-**-*****-**-**-*****-**-
-**-**----**-**-**-**-**----**-------**----**-**-------**----**-**-**-**-**----**-**-**----**----------**-**-**----**----**-**-**-**----
-**-********-*****-**-*****-*****-*****-*****-**************-**-**-**-********-**-********-**-**-**-*****-**-**-*****-********-**-*****-
----**-------**----**----------------**----**----**----**----**-------------**-**----------**-**-**----**-**----**----**----**----**-**-
-**-*****-**-**-********-********-**-********-**-*****-**-********-**-**-********-**-*****-********-**-*****-***********-**-**-*****-**-
-**----**-**-**----**-------**-**-**----------**-------**-**-------**-**-**----**-**----**-**----**-**-**----**-**----**-**-**----------
-**-**-*****-*****-**-********-**-**-**-***********-**-**-**-********-*****-********************-**-***********-**-********-**-********-
-**-**-------**-**----------**----**-**-**-**-------**-**----**-------------**----**----**-------**-**----**----------**-------**-**----
-*****-**-**-**-********-**-**-**-**-**-**-**-**-*****-**-*****-***********-**-*****-**-**-*****-********-*****-*****-*****-*****-*****-
-**----**-**-**-**-------**-**-**-**-**-**----**-**-**-**-**-------------**-**----**-**-**-**-**----**----**----**----**----**-**-------
-**************-*****-**-*****-*****-********-*****-*****-********-*****-**-**-**-**-*****-**-**-*****-***********-**-**-**-**-********-
-------**----**-**-**-**-**----**-**-**-------**-------**-**-------**----**-**-**----**-------**-------**----------**----**----**-------
-**-*****-*****-**-*****-*****-**-*****-**-**-**-**************-*****-*****-**-********-********-**-*****-********-*****-*****-*****-**-
-**----**-------**----**----**-**-**----**-**----------**-**-**-**----**-------**-------**----**-**-**-**-------**-**----**-**-**----**-
-********-**-**-**-**************-*****-*****************-**-**-********-*****-*****-**-**-*****-*****-**-***********-**-**-*****-*****-
-**-**----**-**----**-------**----**----**----**-------**----------**----**----**----**----**----------------**-**-**-**-**-**----**-**-
-**-**-********-**-********-**-**-*****-**-********-**-*****-*****************-********-**-********************-**-**-**-**-********-**-
-**-------**-**-**-------**-**-**-**-**-**----------**----------**----**-------------**-**-**----**-**-**-------------**-**-**----------
-*****-*****-*****-********-*****-**-*****-***********-*****-**-**-*****-**************-********-**-**-*****-**************-***********-
-------**-------------**-------**-------------------**----**-**-**----**----**-**----------------**-**----**-**-------**-**-------------
-**-*****-***********-**-***********-**-*****-***********-********-***********-**-***********-**-**-*****-*****-*****-**-*****-**-*****-
-**----**-------**-------------**-**-**----**----------**-**-------**----**-**-**----------**-**----**-**-**-------**-**----**-**-**----
-*****-***********-********-*****-********-**-**-*****-********-**-**-*****-**-********************-**-**-*****-**-*****-**************-
----**----**-**-------**-------------**----**-**-**----**-------**----**-**----**----**-------**----**----------**-**-------**----**----
-***********-**-*****************************-*****-**-**-*****-********-*****-**-**-*****-**-********-********-**-*****-********-**-**-
-**----**-------**-**----**-**-**-**-**----------**-**-------**----------**-------**-------**-------**-------**-**-**-------------**-**-
-**-***********-**-**-**-**-**-**-**-**-**-********-********************-**-***********-**-**-**************-**-********-********-*****-
-------**-------------**-**-**-**-**----**----**-**-**----**----**-**----------**-**-**-**-**-**-**-------**-**-**-**-------**-**----**-
-*****-********-**-*****-**-**-**-*****-********-*****-********-**-********-*****-**-**-********-**-*****-**-*****-**-**-*****-*****-**-
-**-**-**-------**-**----**-**-------**-**----**----**----------**-**-**-**----------**-**----**----**-**-**----**----**-**-------**-**-
-**-***********-***********-*****-********-*****-********-*****-**-**-**-**-*****-*****-**-***********-**-*****-**-**-**-**-***********-
-**----**----------**----**-**-**-**----**-------------**-**-**----**----------**----**-**-------------**----------**-**----**-**-------
-**-********-***********-**-**-**-*****-**-********-**-*****-*****-***********-*****-**************-********-*****-**-**-**-**-*****-**-
----------**-**----**----**-------**-**----------**-**-**-------------------**----**-------**-**----**----**-**----**-**-**----**----**-
-**-********-**-**-*****-*****-**-**-**-**************-**-***********-**************-**-*****-**-**-*****-**-**************-**-********-
-**-**-------**-**-------**----**-**----**-------------**-**-**----**----------**----**-**-**----**----------------**-**-**-**----------
-***********************-**-**-**-********-*****-*****-**-**-**-********-**************-**-**-********-**-**-********-**-**-*****-*****-
----**-------**----**----**-**-**-**----------**-**-------------**-**-**-**-**----**-------**----**-**-**-**-**----------**----**----**-
-**-*****-*****-********-**-********-**-**-*****-*****-********-**-**-**-**-**-**-*****-**-**-*****-*****-*****-**-**-**-*****-********-
-**-------**----**-------------**-**-**-**----**-**-------**-**-**-**----------**----**-**-**-------**-**-------**-**-**----**-**-------
-*****-*****-*****-********-*****-**-**************-**-*****-**-**-**-**-**************-**************-********-*****-***********-*****-
-**-------**----**----**-------------------------**-**-**-------**----**-------------**-------**-**-**----**-**-**-**-**----**-**-**-**-
-********-**-*****-***********-**-*****-********************-*****-**-***********-*****-**-*****-**-**-**-**-**-**-*****-**-**-**-**-**-
-**-**----------------**----**-**-**-**-------------**----------**-**-**----**-**-**----**----**-**-**-**-------------**-**-**----**-**-
-**-**-*****************-*****-*****-*****-**-*****-*****-**-********-*****-**-**-*****-********-**-**-*****-**************-**-*****-**-
-**----**-------**-**-**----**-------**----**----**-**-**-**-**----------------**-**----------**-**-**-**-**-------**----------**-------
-*****-**-*****-**-**-**-********-********-**-********-**-*****-********-**-**-**************-**-**-*****-**-********-**-*****-*****-**-
----**-**-**-**-**----**-**-------**-------**-**-**----------**-**-------**-**-**-**----**-**----------**----------**-**-**-------**-**-
-***********-**-**-**-**-********-**************-********************-*****-*****-**-**-**-**-********-*****-*****************-**-*****-
-**----------**----**----**-------**----------**-**----------**----**-**-------**----**----**----**----**----------**-------**-**-**----
-**-**-**-********-*****-*****-***********-*****-***********-*****-**-********-**-*****-**************-********-*****-*****************-
-**-**-**-------**-**-**----**----**----**-**----**----**-**----------**-**-**----**-**----**-------**----**----**-------------**----**-
-*****-*****-*****-**-********-*****-*****-**-*****-**-**-**-***********-**-**-**-**-*****-********-*****************-**-********-*****-
-------**----**-------------**-**----**-------**----**-**----**-**----**----**-**-**----**----------**----------**-**-**-------**-**----
-**************-***********-**-**-**-**-**-**-*****-**-********-**-*****-**-********-**-***********-**-***********-**-*****-**-**-**-**-
----**----**-**-**-**-**----**-**-**-**-**-**-**-**-**-**-**-**-**----**-**----**----**-------**-**-**-------**----------**-**-**----**-
-********-**-*****-**-*****-*****-**-**-********-**-*****-**-**-**-********-********-***********-*****-**-********************-*****-**-
-**-------------------**----**-**-**----------**-**-**-**-**-------------**----**----------------**-**-**-**----**-**-**-**-------**-**-
-***********-********-**-*****-**-********-*****-**-**-**-********-*****-*****-********-**-********-*****-**-**-**-**-**-********-*****-
----------------**----**----**-**-**-------------**----**----**----**-**-**----**-------**----**-**-**-**-**-**----**-**----**----**----
-********-**************-**-**-*****-**-**-*****-**-*****-*****-**-**-********-**************-**-**-**-**-*****-*****-*****-*****-**-**-
-**----**-**-**-------**-**-**-**-**-**-**-**----------**-------**-**-------**-**-**-**----**-------------------**-------**----------**-
-*****-**-**-*****-*****-*****-**-**-**-**************-**-********-**-**-*****-**-**-*****-**-*****************-**-**-*****************-
-**-**----**-------------**-**----**-**-**----**----**-------**----**-**----**-------**-------**----**-------**-**-**-**-**-**-**-------
-**-**-**-********-*****-**-**-*****-**-**-**-*****-**-********-*****-**-**-*****-**-**-***********-**-**-*****-*****-**-**-**-**-*****-
-**----**-**-------**-------------**-**-**-**----**-------**----**----**-**-------**-**-**-------------**-**-**-**-**----------**-**-**-
-**-**-********************-**-*****-*****-**-********-**-**-**-**-********-*****-*****-*****-***********-**-*****-********-**-*****-**-
-**-**-**----**-------------**-**-------**-**----**-**-**-**-**-**-------**-**----------**----**----**-------------**-------**----**-**-
-********-********************-*****-********-*****-***********************************-*****-**-********************-**************-**
-------------------------------------------------------------------------------------------------------------------------------------*$
