14 14
#**----------------------------------------
******-********************-**************-
-**-------**-**----**-**----------------**-
-***********-**-**-**-**-*****-**-**-**-**-
----------**----**----------**-**-**-**-**-
-*****-**-********-*****-**-**************-
-**-**-**-**----**-**-**-**----**----**----
-**-********-**-*****-**-********-********-
----------**-**-**----**----**-**-------**-
-***********-*****-*****-**-**-********-**-
-**----**-------**-**-**-**----**-**----**-
-**-*****-*****-**-**-**-*****-**-**-**-**-
----------**-**----**-**-**-**-**-**-**-**-
-*****-*****-*****-**-*****-*****-*****-**-
-**-------**----**-------**-**----------**-
-***********-**************-**-**-*****-**-
----------**-------**-------**-**----**-**-
-*****-*****-*****-**-***********-********-
-**----**-**-**-------------**-------------
-*****-**-**-**-*****-**************-*****-
-**----**----**----**----**----**----**----
-***********-***********-*****-**-**-*****-
-**----**-------**-------------**-**-**----
-*****-*****-***********-**-********-**-**-
-**----**----**----------**----**----**-**-
-**-**-**-**-**-**-**************-**-*****-
----**-**-**-**-**----**-**----**-**----**-
-********************-**-*****-***********
----------------------------------------*$
