50 50
#**----------------------------------------------------------------------------------------------------------------------------------------------------
***-********-***********-********-***********-********************-***********-**************-********-**-**-*****-***********-**-*****-*****-********-
-**-**----------**----**----**-**-**----**-------**-**-**-------**-**----**-**-------**-------**-------**-**-**-------**-**----**-**-------**----**----
-********-***********-**-*****-**-*****-**-*****-**-**-********-**-**-**-**-***********-**-**************-**************-**-**************-***********-
-**-**-**-**----------**-------**----**-**----**-------**----**-------**-**-------**----**-**-**-**-**----**----**----------**----------------**----**-
-**-**-********-*****-**-**************-**-**-*****-********-***********-**-**-*****-********-**-**-**-**-*****-**-**-**-*****-**-**-**-*****-**-**-**-
----------**-------**-**----------**-**-**-**----**-**-**-**-------**-------**----**-**-------------**-**----**-**-**-**-**----**-**-**-**----**-**-**-
-**-********-********-**-********-**-**-**************-**-*****-**-*****-**-********-********-**************-**-**-***********-*****-********-**-**-**-
-**-------**-**-**-**----**-**-------**----**-**-------**-**----**-**----**-**-**----**-------------------**-**----**-------**-**-------**-------**-**-
-********-**-**-**-**-*****-***********-*****-**-*****-**-**-**-***********-**-**************-********-********-********-*****-**-********************-
-**-**-**-**-**----------------**-**----**-**-**-**-**-**----**-**----------**----------**-**----**----------------**----**----**-**-**-**----**-------
-**-**-**************-*****-**-**-*****-**-**-**-**-**-*****-***********-**-**-*****-*****-**-**-*****-**-**-**-*****-**-***********-**-**-*****-**-**-
-**-**-**----------**-**----**-**----**----------**-------**----**-**----**-**-**----**----**-**-**----**-**-**-------**----**----**-**----------**-**-
-**-**-**-**-**-**-*****-*****-*****-***********-**-***********-**-**-*****-**-********-*****-**-**-*****************-********-*****-********-********-
----------**-**-**----**----**-**----------------**----**-------------**-**-**----**-**-**----**-**-**-**----**----------------------**-**-**-**-**-**-
-**-**-**-**-**-*****************-*****-********-*****-**-**************-**-**-*****-**-**-********-**-*****-*****************-*****-**-**-*****-**-**-
-**-**-**-**-**----------**-**-------**-**-**-------**-**----**----------**----**-**----------**-------**-------**----------------**-**-**-------------
-**-**-********-*****-*****-********-*****-*****-**-*****-*****-********-********-**-**-********-**************-**-********-**-********-*****-********-
-**-**-**----------**-**----**----**-**----------**-------**-**----**----**-**-**----**----**-------**----**-**----------**-**-**----**-------**-------
-**************-**-*****-*****-**************-**-*****-**-**-**-**-**-**-**-**-*****-********-**-*****-**-**-**-********-*****-**-*****-**************-
-------**----**-**----------**-------**----**-**-**----**-------**-**-**----**-------------**-**-**-**-**-**----**-**-**----**-**----**-**-**-------**-
-*****-**-********-********-*****-********-********-*****************-*****************-**-**-*****-**-**-********-**-**-********-********-**-********-
-**-**----**-------**----------**-**-------**-------**-**-**-**-------**----**----**----**-**-**----**-**----**----**----------**-**-**----**-**-**-**-
-**-********-********-********-**-**-**-********-*****-**-**-********-*****-*****-********-*****-**-********-*****-********-**-**-**-*****-**-**-**-**-
-**-**----**-------**-**----**----**-**----**-**-**-**----------**----**----------**----**----**-**----**-------------------**-**-**-**-**-**----------
-**-**-********-**-********-*****-*****-**-**-*****-**-**-**-***********-**-***********-********-**-**-**-*****-**-********-*****-**-**-**-*****-*****-
-**-**----**----**-**-**-------------**-**----**-**----**-**-**-**----**-**-**----**----**----**-**-**----**-**-**----**-**-**-------**-**----**----**-
-**-**-**************-**************-*****-*****-*****-********-**-*****-**-**-*****-*****-********-**-**-**-**-*****-**-*****-**-**-**-**-********-**-
-------------**----**-------------**----**-**-------**-**----**----**----**----------**----**----**-**-**-**----**-------**----**-**----------**-**-**-
-**-***********-********-********-**-*****-**-*****-**-*****-*****-**-***********-********-*****-**-**-**-*****-***********-*****-**-********-**-*****-
-**-**----------------**-**----------**----------**-------**-**-------**-------**-------------------**-**-**-**-------**-------**-**-**----**-**-------
-**-**-***********-**-**-*****-*****************-***********-**-**-**-********-*****-*****-********-********-**-***********-**************-**-**-*****-
-**----**----**----**-**----**-**-------**----**-**-**-**----**-**-**-**----**----------**-------**-------**-------**----**----**----**-**----------**-
-*****-**-**-*****-*****-***********-**-*****-**-**-**-**-**************-********-*****-**-**-*****-***********-**-**-**-********-**-**-**-********-**-
----**-**-**----**-**-------**----**-**-**----**-**-------**-**-**-**----**-------**----**-**-**-**----**-**-**-**----**-**----**-**-------**----**-**-
-***********-**-**-***********-********-**-*****-*****-**-**-**-**-*****-********-**-********-**-**-*****-**-**-********-**-*****************-*****-**-
----**----**-**-**----------**----------------**----**-**-**----------------------**-**-**----**-**----------**-------**-**-**----**----------------**-
-********-**-**-**************-*****-***********-********-**-*****-**-***********-*****-********-*****-*****-**-**-**-**-**-*****-********************-
----**-------**----**-------**-**-**-**-------------**----------**-**-**----------------**-**----**----**----**-**-**-**----**-**-**-------**-**-**-**-
-********-**-**-**-**-**-**-**-**-**-**-*****-**-**-**-**-***********************-********-*****-*****-*****-*****-*****-**-**-**-*****-**-**-**-**-**-
-**-**-**-**-**-**-**-**-**----**-------**-**-**-**----**----**----------------**----**----**-------**-**-**-**----**-**-**----**----**-**-------**-**-
-**-**-***********-********-********-**-**-*****-**-**-**************-**************-**-*****-********-**-********-**-*****-********-**-***********-**-
-**-------**-**-**----**-**-**-**-**-**----**----**-**-------**-**----**----------**-------**-------**-------**----------**----**----------**-------**-
-**-**-*****-**-*****-**-*****-**-*****-***********-*****-*****-**-*****-**-**-********-********-********-**-*****-***********-**-*****-**-*****-*****-
-**-**----**-**----**-**----------------**----**----**-------------**-**-**-**-------**-**-**----------**-**-**----**-**-**----------**-**-**-------**-
-*****-**-**-**-*****-**-**-********-**-**-*****-**-********-*****-**-**-*****-**-*****-**-*****-********-**-**-*****-**-*****-**-********-**-*****-**-
-------**-**-**----**-**-**----**-**-**-**----**-**-**----**-**-------**-**-**-**-**----**-**-**----**-**-**-**----**-------**-**-------**----**-**-**-
-**-**-*****-**-*****-***********-**-**-*****-**-********-**-********-**-**-*****-**-*****-**-**-**-**-*****-**-***********-**-**-**-**-**-*****-**-**-
-**-**----**-------**-------**-------**-------**-**----**-**-**-**-------------**-**----**-**-**-**-**----**-**-**-------**-**-**-**-**-**-**-------**-
-**-**-**-*****-**-*****-**************-*****-*****-*****-**-**-********-**-*****-********-**-**-*****-**-*****-*****-*****-*****-*****-**-**-*****-**-
-**-**-**----**-**----------**-**-**----**----------------**-**----------**-**----**-**----**----------**-------**-**-**----------**----**-**----**-**-
-********************-*****-**-**-**-**************************-********-**-********-**-*****-***********-********-**-********-***********-********-**-
-------**----------------**----**----------------------**-------**-------**----**----**-------**-------**----**----**----------------**----**-**-**-**-
-**-********-*****-*****-********-*****-***********-*****************-***********-**-**************-********-**-**-**-********-********-*****-**-*****-
-**-**----**-**-------**-**----**-**----**-**-------**-**-**----------**-------**-**----**----**-------**-**-**-**-**-**-------------**-**-------**----
-*****-*****************-*****-**-*****-**-**-**-*****-**-**-*****-********-**-********-*****-**-**-**-**-**-*****-**-********-**-***********-**-**-**-
----**----**-**----**-------**----**-**-**-**-**----------**-**----**-------**-**-------------**-**-**----**-------**----**----**----**-------**-**-**-
-**-**-**-**-**-***********-**-*****-**-**-*****-***********-**-********-*****-**-*****************-*****-*****-**-**-*****-**-*****-*****-**-**-*****-
-**-**-**----------------------**----**-**----**-------**-**-**----**-**----**-**-**-**-------**-**-**----**----**-**-**----**-**----------**-**----**-
-********-*****-********-**-*****-********-**-**-**-**-**-********-**-*****-*****-**-**-********-**-*****-**-**************-********-**************-**-
-**----------**-**-------**-------**-**-**-**-**-**-**-**----**----------**-**----**----------**----**----**-------**----**-------**----**----**----**-
-*****-*****-***********-********-**-**-*****-*****-**-*****-**-**-**-*****-*****-********-*****-*****-**************-**-*****-*****-**-*****-*****-**-
-**----**----**----**-**-**-**----**----**----------**-**----**-**-**----**-**----**-**-------**----**-------------**-**----**-**----**-------**-**-**-
-***********-**-*****-*****-**-********-*****-*****-********-**-********-**-**-*****-**-***********-***********-*****-**-**-**************-**-**-*****-
----**-**-**-------**-------**-------------**-**----**----------------**-**----**-------**-**----**-**-------**----**-**-**-**-------------**-**-------
-*****-**-**-***********-**-*****************-*****-********-**-********-*****-*****-*****-*****-*****-**-**-*****-**-**-*****-***********-*****-*****-
-**-------**----**-------**-------**-------------**-**-**----**-**-**----**-**-------**----**-------**-**-**----------**----**-**-------**-**-**-**-**-
-*****-**-**-***********-*****-**************-*****-**-********-**-*****-**-**-**-*****-**-*****-**-*****-***********-**-*****-**-***********-*****-**-
-**-**-**-**-------**-------**----**-------**-**-**----**-**-------**----------**-**-**-**-**----**-------**-**-------**----------**-**----------------
-**-*****-*****-**-**-*****-**************-*****-*****-**-**-*****-***********-**-**-**-********-**-*****-**-**-**-**************-**-********-**-**-**-
-**-------------**-**----**-------**-**----**----------**-------**-**----**----**-**----**-------**----**----**-**-**----------**-**----**-**-**-**-**-
-*****-********-**-**-**************-**-**-**-**-**-*****-********-*****-**-**-*****-**-**-**-***********************-**-**-***********-**-***********-
----**-------**-**----**----**-**-**-**-**----**-**----**-**----**-**----**-**-**-**-**-**-**-**----**-------------**-**-**----------**-------**----**-
-***********************-*****-**-**-***********-********-*****-********-**-**-**-*****-********-*****-**-**-*****-**-*****-*****-**-**-********-**-**-
-**-------**----**-------------**----**-**-**----**-**-**-------**-**-**----**-------------------**----**-**-**-**----**----**----**-**----**-**-**-**-
-********-**-**-*****-********-**-*****-**-*****-**-**-**-*****-**-**-*****-********-********-*****-********-**-**-**************-********-**-*****-**-
-------**----**-**-------**-**-------**----**----------**----**-**----------**----------**-**-**----**-**----**----**-**----**-------**-**-**-------**-
-***********-********-*****-**-*****-*****-**-**-***********-*****-********-**-*****-**-**-**-**-*****-********-**-**-*****-**-**-*****-**-**-*****-**-
-------------------**-**----------**-**----**-**-**----**-------**-**-------**-**----**-**----**-**-**-------**-**-------**----**-**-------**-**-**-**-
-**-**************-**-*****************-*****-**-**-**************-*****-**-*****-*****************-*****-**-********-********-**-**-*****-*****-**-**-
-**----**-------**-**----**----------**----**-**----**----------**-**----**-**----**----**-**-**-**-**-**-**-**-**----**-**----**-------**-**-**-**----
-*****-*****-*****-*****-**-*****-**-**-**-**-**-*****-*****-**-*****-**-**************-**-**-**-**-**-*****-**-********-*****************-**-**-*****-
----**-**-**-------**-------**-**-**-**-**----**----**-**----**-------**-**-------------------**-------**-------------**----------**-**----**-**----**-
-********-*****-***********-**-***********-**-*****-**************-********-***********-**-**-**-********-**-*****-**-**-*****-*****-*****-**-**-*****-
-**----------**-**-------**-------**-------**-**-**-**----------**-**-------------**-**-**-**-**----**----**----**-**-**----**-**-------**-------------
-*****-**-**************-**-**-***********-*****-***********-*****-*****-**-**-*****-*****-**-**-********-********-***********-**-**************-*****-
----**-**----**-**----------**-**-**-**-------**-------------**-**-**-**-**-**-**----**----**----------**-------**----**-------------**----------**----
-**-**-*****-**-**************-**-**-********-********-********-*****-***********-**************-*****-**-********-**************-********-**-********-
-**-**----**----**-**-**-------------**-------**----**-------**-**-**----**-**-**----------------**----------**-------------**----**-------**-**-**----
-*****-***********-**-*****-*****-********-**-*****-********-**-**-*****-**-**-********-***********-********-**-**-**-***********-**-*****-*****-**-**-
-**-------**----------**----**-**-**-**-**-**-**-**-**-------------------------------**----**-**-**-------**-**-**-**----**-------**-**-**-------**-**-
-**-*****-**-********-**-**-**-*****-**-**-*****-**-**-**-*****-***********-**-**-********-**-**-********-********-**-***********-*****-**-********-**-
-**-**-------**-------**-**----**----**----**-**-**----**-**-------**-------**-**-------**-**-------**----**-------**-**-**----**-------**-**----**-**-
-*****-*****-*****-********-**-**-**-*****-**-**-**************-********-**-*****-*****-*****-**-********-***********-**-*****-**-**-***********-**-**-
-**-**-**-**----**-**-**-**-**-**-**-**-**----------**-------**-**-**----**-**----**-**-**-**-**----------**-------**-**----**-**-**----------**-**-**-
-**-**-**-**-********-**-**-**-**-**-**-**-***********-********-**-*****-********-**-*****-********-********-*****-********-**-**-**-**-**-*****-*****-
----**----**-**-------------**----**-**----**-**-**-------**----------**-**-**----------**-------**----------**----------**-------**-**-**-**----**-**-
-*****-*****-**-*****-**-*****-***********-**-**-*****-**-********-********-********-**-*****-**************-**-**-**-********-**-*****-********-**-**-
-**-------**-**-**-**-**-**-**-------**----------**-**-**----**----**----------------**-**----**----------**-**-**-**-------**-**-**-**-**----**----**-
-**-**************-*****-**-***********************-********-*****************-***********-***********-*****************-***********-**-**-********-**
----------------------------------------------------------------------------------------------------------------------------------------------------*$
