73 109
#**----------------------------------------------------------------------------------------------------------
*********************-*****************-***********-********-***********************-*****-*****-**-********-
-**----**-------**-**-**-------**----**----**----**-**----**----**-**-**----**-------**-**-**----**-**----**-
-*****-********-**-*****-*****-*****-*****-**-*****-*****-********-**-*****-**-********-**************-*****-
-------**-------**-------**----**-------**-**----------------**-**-**-------**-------**----**----------------
-********-********-*****-*****-**-*****************-********-**-**-**-********-********-*****-********-**-**-
----**----**-------**-------**----------**-------**-------**----------**-**-**-**-**-------------**-**-**-**-
-********-*****-**-**-********-***********-********-********-**-*****-**-**-*****-**-**-**-**-*****-********-
-------**----**-**-**-------**----------**-------------**-**-**----**-------**-**-**-**-**-**-**-**----**----
-********-********-**************-**-**-********-*****-**-*****-**************-**-**-**-********-**-*****-**-
-**-**----**----------------**-**-**-**----**-**----**----**-**----**----**-------**-**-**-**----------**-**-
-**-**-*****-**-*****-********-*****-********-**-*****-*****-**-********-**-*****-*****-**-**-**************-
-**----**----**-**-**----------**----------------**-**-------**----**----------**-**-**----**----**-------**-
-*****-**-*****-**-**-********-********************-********-********-*****-********-**-********-*****-*****-
----**----**-------**-**----**----**----**-------------**----**----**-**----------**-**----**-------**-**----
-**************-********-**-**-**-**-*****-***********-**-**-**-********-*****-*****-**-********-**-**-*****-
-------**-**-**----------**-**-**----------**-------**-**-**----**----**----**-**-**----**-**----**----------
-********-**-********-***********************-********-**-**-**-**-***********-**-********-*****-***********-
-**----**----------**----**-------**----**-**-------**-**-**-**-**----**----------**-**----------**----------
-**-*****-*****-*****-********-**-**-**-**-********-***********-**-**-**-**-*****-**-*****-*****-***********-
----**-**-**----**-------**-**-**----**-**----------------**-**----**-**-**-**-------**-------**-**----------
-**-**-**-*****-*****-*****-*****-**-*****-*****-***********-***********-*****-*****-**-***********-*****-**-
-**----**-**-**----**----------**-**----**-**-**-------**----------**----**-**-**----**-**----**-**-**----**-
-*****-*****-**-**************-**-***********-**-*****-**-********-**-*****-**-**-**-*****-*****-*****-**-**-
-**-**-------------**----------**-------**----------**-**-**-**-------**----**-**-**-**-------**----**-**-**-
-**-**-*****-**-**************-*****-**-*****-********-**-**-*****-*****-**-********-**-********-**-********-
-**-------**-**-**-------**-------**-**----**----**-**-------**----------**-------**-------------**----**----
-*****-*****************-*****-*****-***********-**-**-***********-**-**-**************-***********-**-*****-
-**----------**----------**-------**----------------**----**----**-**-**-**----------**-**-**-------**-------
-********-***********-**-**-***********-********-********-**-*****-********-*****-*****-**-**-**-**-**-**-**-
----**----**----**-**-**----**----**-**-------**-**-------**-**-**----------**----**----**-**-**-**-**-**-**-
-*****-**-*****-**-**-********-*****-*****-***********-*****-**-***********-********-**-**-*****-*****-*****-
-**----**-**-**-**----**----------**----------**-**----**----**----**-**----**----**-**-**-**-**----**----**-
-**-********-**-**-***********-*****-**-********-********-**-**-**-**-********-*****-*****-**-**-********-**-
-**----**----**-**----**----------**-**-**-**-**-------**-**-**-**----------**-**-**-**----**-------**-**-**-
-*****-**-*****-*****-**-**-**-********-**-**-********-**-**-*****-**-**-*****-**-**-**-*****-**-*****-*****-
-**----**-**-**----**----**-**----**----------**----**----**----**-**-**----**-**-**-**----**-**-**-------**-
-********-**-*****-**************-********-**-*****-**-*****************-**-**-**-**-*****-**-**-**-*****-**-
----**-------**-**-**-------**-**----**-**-**-**-------**-------------**-**-**----**-**----**-**-------**-**-
-*****-********-**-**-**-**-**-**-*****-**-***********-**-********-********-**-*****-*****-********-********-
-**----**-------**-**-**-**----------**-------**-**-**-------**-------**----------**-**-**-------**-**-**-**-
-**-*****-*****-**-***********-********-********-**-*****-********-********-**-**-**-**-**-**-*****-**-**-**-
-**-------**----**----**-------**-**-**----------**-------**-**----**----**-**-**-------**-**----------**----
-**-**-**-***********-**-********-**-***********-***********-*****-**-**************-**-********************-
-**-**-**-**-**----**-------------**-**-**----**-**----**-------------**-------**-**-**-------------**-------
-*****-**-**-*****-**-********-*****-**-*****-**-*****-**-**-***********-********-**-**-***********-*****-**-
-**----**-------**-**----**----**----**-**----------**----**----------**----**-------**-**----**-**-**----**-
-*****-*****-*****-**-**-**-*****-*****-**-**-********-**-*****-*****-**-**-********-**-*****-**-*****-*****-
----**-**----------**-**-**-**----**-**----**----**-**-**-**-------**----**-------**-**----**-------**-**----
-***********-**-**************-*****-*****-*****-**-**-*****-**************************-*****-**************-
-**----**----**----**----**-**----------**----**-------**-**-**----**-**----------**-------------------**-**-
-**-*****-********-**-**-**-***********-********-********-*****-*****-**-********************************-**-
-------------**-**-**-**----**-**-**-**----------**-------**-**----------------**----**-**-**-**----**-**-**-
-********-*****-***********-**-**-**-*****-*****-*****-*****-**-**-********-********-**-**-**-*****-**-**-**-
-**----**-------------**----**-------**----**-------**-**----**-**-------**----**-------------**----**-------
-**-********************-*****-***********-**-*****-**-**-********-*****-**-*****************-**-********-**-
----**-**----------**----**-**-**----**----**-**-------**-**-**-**-**----**-**-------**-**-**----**-------**-
-*****-**-**-**-*****-**-**-**-**-**-*****-**************-**-**-**-**-**-********-*****-**-*****-********-**-
-**----**-**-**-------**----**-**-**-**-**----**-------------------**-**----**----**-**-**----------------**-
-**-**-*****-**-***********-**-**-*****-**-***********-**-**-********-***********-**-**-**-**************-**-
-**-**-**-**-**----------**-------**-**-------**-------**-**-**-------**----**----**-**----**-**----**----**-
-*****-**-*****-********************-********-********************-*****-********-**-**-*****-**-**-********-
----**----**-------**----------**----**----------**-**----**----------**-**----------**----**-**-**-------**-
-********-**-**-********-**-**-**-********-********-*****-********-*****-**-***********-**-**-**-********-**-
-------**----**-------**-**-**-**-------**-**----**-------------**-------**-**-------**-**-**-------**-------
-*****-*****-*****-***********-********-*****-********-**************-**-**-**-**-********-*****-***********-
-**-**-**-------**-**-**-------**----**----------**----------**----**-**-**----**----**-**-**----**-------**-
-**-**-**-********-**-*****-**-**-********-**-*****-*****-*****-*****-********-********-*****************-**-
----**-**-------**----**-**-**-**----------**-**-------**-**-------**----**----------**----**----**----**----
-*****************-**-**-**-**-*****-*****-*****-***********-**-*****-**-*****-**-**-**-********-**-********-
-------**----------**-------**----**----**-**----**----**----**----**-**----**-**-**----------**----------**-
-**************-***********************-********-**-********-********-********************-***********-*****-
----------------------------------------------------------------------------------------------------------**$