69 26
#*************************
-------------------------*
**************************
**************************
**************************
*-------------------------
**************************
**************************
**************************
----*---------------------
**************************
**************************
**************************
**************************
**************************
**************************
**************************
**************************
**************************
------------*-------------
**************************
**************************
**************************
**************************
**************************
**************************
**************************
**************************
----------------------*---
**************************
**************************
**************************
**************************
**************************
**************************
**************************
**************************
**************************
**************************
**************************
**************************
**************************
**************************
**************************
**************************
**************************
**************************
**************************
**************************
**************************
**************************
**************************
**************************
**************************
**************************
**************************
**************************
**************************
**************************
**************************
**************************
**************************
**************************
**************************
**************************
**************************
**************************
**************************
*************************$