68 103
#**----------------------------------------------------------------------------------------------------
***-***********-**************************-********-***********************-***********************-**-
-**----**----**-------**----------------------**-**-**----------**-------**-**----**-**----**-------**-
-********-*****-**-********-**************-*****-********-********-*****-*****-*****-**-*****-********-
-**-**-**-------**-**-**-**-**----**----**-**-**-**-------**----**----**----------**-------**-**----**-
-**-**-***********-**-**-**-*****-**-********-**-**-*****-**-*****************-*****-***********-*****-
-**-------**-------------**-**-------------**----**-**-**----------**----------**-------------**----**-
-**-*****-********-********-**-********-********-**-**-***********-**-********-**-********-**-**-*****-
-**----**----**-------**-**----**----------------------**-------**----------**----**----**-**----**----
-**-**-*****-*****-*****-***********-*****-**-*****-**-**-***********-*****************-**-********-**-
-**-**----**----**-**----**-------**----**-**-**----**-**----**----**-**-------**-------**----**----**-
-*****-*****-*****-**-*****-*****-*****-********-*****-**-**-**-**-**-**-*****-**-**-**-***********-**-
-**----**----**----**-**-**-**----**----**-**-**-**-------**-**-**-**----**----**-**-**-------**----**-
-*****-*****-********-**-*****-**-********-**-********-**-*****-*****-**************-********-**-*****-
----**----**-------**----------**-------**-------**-**-**-**----**-------------**-**----**-**----**----
-*****************-*****-*****-*****-**-**-********-**-********-********-*****-**-********-***********-
-**-------**----**-------**-------**-**----**----------**-------**-**-**-**----**-**-------------------
-********-*****-********-**-**-*****-*****-*****-*****-**-**-*****-**-**-*****-**-*****-**************-
-------**-------------**-**-**-**----**----**-**-**----**-**-------**-**----**-**----------------**----
-********-***********-**-**-**************-**-***********-**-**-*****-**-**-********-***********-*****-
-**-**----------**-**-**-**----**----**-------**----**----**-**-------**-**-**-**----------**----**----
-**-**-**-********-***********-*****-********-*****-*****-**-*****-********-**-**************-**-**-**-
----**-**----**-**-**-**----**----**-**----**-**----**-**-**----**-**-**-**-**-------**-**----**-**-**-
-**-**-********-**-**-**-**-**-*****-*****-**-*****-**-********-**-**-**-********-*****-**************-
-**-------**----------**-**-------**-------------**-------**----**-------**----**-**----**----**-------
-*****-*****-*****-**************-**-**-*****-*****-********-*****-*****-**-**-**-*****-*****-********-
----**----**-**----**-------**----**-**-**-**-------**-**-**-**----**-------**-**----------**----**----
-**-*****-*****-***********-********-*****-**-*****-**-**-**-********-**-********-***********-********-
-**-**----------**----**----------**----**----**----------**----**-**-**-**-**----**-**-**----**-**-**-
-**-*****-**-********-*****-**************-**-**************-**-**-*****-**-**-**-**-**-**-*****-**-**-
-**----**-**----**-**-------**----**-**----**-**----**----**-**-**-------------**-**-------------------
-*****-********-**-**-********-*****-********-**-*****-**-**-***********-*****-********-**************-
----**----**-**----**-------**-**----**----**----**----**-------**----**----**----**-------**----------
-***********-**-**-*****-*****-**-*****-*****-********-**-********-**-**-********-********-***********-
-**-**----**----**-**-------**-**-------**-**-**----**-**-**-------**----**-**-**-**-**-**-**----**----
-**-*****-***********-**-*****-**-********-**-*****-********-**-***********-**-*****-**-********-*****-
----**-**-**-**----**-**-**-**-------**-------------**-------**----------**-------**----**----**-------
-*****-**-**-**-**-*****-**-**-**************-*****-**-**-**-***********-**-********-**-*****-*****-**-
----**----------**-------**-------**----------**-------**-**-**----**-**----**----**-**----**-------**-
-*****************-********-**-**-*****-********-*****-**-********-**-***********-**-**-*****-********-
-**----**----**-------------**-**-------------**----**-**-------------**-------**----**-**----**-**----
-**-**-**-*****-*****-*****-*****-***********-**-*****-*****-*****-*****-*****-**-**-**-**-*****-*****-
-**-**-**----**-**-**-**----**----------**-**-**-**-**-**-------**----**----**----**-**-**-**----**----
-*****-*****-*****-**-*****-**-********-**-**-*****-***********-**-**-**************-***********-**-**-
-------**-------**----**----**----**-------**-**-**----**-------**-**-------**-------------**----**-**-
-***********-********-**-*****************-*****-**-**-*****-********-*****-********-**-********-**-**-
-**-**-------**----**-**----**-------**-**-**-------**-**----------**-**-------**-**-**----**-**-**-**-
-**-*****-*****-********-**-*****-*****-**-*****-**************-*****-*****-*****-********-**-**-*****-
-**----------**-**----**-**-**-**----------**-------**----**----**-------**-**-**-**----**-------**-**-
-*****-**-*****-**-*****-*****-*****-********-*****-**-********-**-**-********-**-*****-*****-*****-**-
-**-**-**-**-**-**----**----**----------**----**-**-**-**-**----**-**----**-**----**----**-------------
-**-**-*****-**-**-*****-**-********-***********-**-**-**-********-********-*****-**-*****-***********-
----------**-**-------**-**-------**-------**----**----**-------**----**----**----------**-------**-**-
-**-********-**-***********-**-**************-**-*****-**-*****************-**-*****-**************-**-
-**----**-------**-**-------**----**-**----**-**-------------**-**-**----**-**----**-**----**-------**-
-********-**-**-**-**-*****-********-*****-**-*****************-**-*****-**-*****-********-**-********-
-------**-**-**-**-**-**-**-**----**----**----------**-**-------**----**----------**----**-**----**-**-
-*****-**-********-*****-**-**-*****-**-********-*****-********-**-**-*****-*****-**-**-**-**-*****-**-
-**-------**----**-**-**----------**-**-------**----**----**-------**----**-**-**-**-**-**-**-------**-
-*****-**-*****-**-**-*****-**-********-********-*****-***********-********-**-*****-*****-********-**-
-**----**-**----**----------**----------------**-**----**----**----**-------**----**----**-------------
-***********-********-*****-**-***********-**-**-**-**-**-*****-**-*****-**-**-**-**-*****-**-**-*****-
-**-------------**-**----**-**-**-------**-**-**-**-**-**----**-**-**----**-**-**-**-------**-**-**----
-**-**-**-**-**-**-*****-*****-*****-***********-*****-**-**-**-***********-**-*****-***********-**-**-
-**-**-**-**-**-------**-**-------**----**----**-**-**----**----------**-------**-**-**-**-**-**-**-**-
-*****-***********-********-*****-**-*****-*****-**-*****-**-*****-***********-**-**-**-**-**-********-
----**----**-**-------**-------**-**-------------------**-**-**-------------**----**----**----------**-
-*****-*****-***********-********************-***********-***********************-*****************-**-
----------------------------------------------------------------------------------------------------**$