35 35
#**-------------------------------------------------------------------------------------------------------
******-**-*****-*****-**************-**-**-*****-***********-*****-*****-********-**-***********-**-*****-
-**----**-**-**-**----**----------**-**-**-**-**-**----**-**----**-**-**----**-**-**-**-**----**-**----**-
-***********-********-**-********-*****-**-**-**-*****-**-**-********-********-*****-**-*****-**-********-
-**-------**----**-**-------**----**----**-**-**-**-**----------------**----------**----**-**-**-------**-
-**-***********-**-**-**-**-***********-*****-**-**-*****-***********-********-********-**-**-***********-
-**-**----------**-**-**-**-**-------**----**----**-------------**----------**-------**-**-**-**-**-------
-**-*****-*****-**-*****-**-********-**-**************-**************-***********-**-*****-**-**-*****-**-
-------**-**-**-**----**-**-------**-------**-------------**-**-**-**-**-------**-**----------------**-**-
-********-**-********-**-**************-**-**-*****-********-**-**-**-********-**-***********-********-**-
-**-------------**-**----------**-**-**-**-**-**-**-**-**-------------**-**-**-**----**-**----------**-**-
-*****-**-*****-**-***********-**-**-*****-**-**-*****-**-********-*****-**-**-**-*****-**-**-**-********-
-**----**-**----**-------**-------**-**----**----**-------**-**-------**-**-------**-**----**-**----**----
-**-********-*****-*****-*****-**-**-***********************-********-**-**-********-*****-*****-**-*****-
-**----**-------**-**----------**----**-**----**-**-------**-**-**-------**-**-**----**-------**-**-**-**-
-**-********-**-********-**-***********-*****-**-**-********-**-*****-********-*****-**-***********-**-**-
-------**-**-**-**----**-**----**----------**-------------**----**-------**----------------**----**-**----
-*****-**-********-*****-**-**-**-********-**-**-********-**-*****-***********-*****-**-********-********-
-**----**----------**----**-**----------**----**----**----**-------------**-------**-**-**-------**-------
-*****-**-*****-********************-*****-*****************-**-**************-**-********-*****-**-*****-
----**-------**----**-**-**----**-------**-**----------**----**----**----**----**----**-------**-**----**-
-**************-*****-**-*****-********************-**-********-*****-***********-********-**************-
-**----**----------**----**----**-**-------------**-**-**-**-**----**----------------------------**-**-**-
-**-***********-**-*****-**-*****-**-*****-********-*****-**-*****-***********************-**-*****-**-**-
----**----------**----**-**-**----**-**-**-**-**----------**-------------**-------**-------**-**----**----
-*****************-**-**-**-**-********-**-**-**-*****-**-**-**************-*****************-**-********-
----**-------**----**-**-**-------------**----**-**-**-**-**-------**-**-**-------**-------------**-**----
-**-********-********-**-*****-*****-*****-********-*****-*****-*****-**-**-**-**-*****-**-*****-**-*****-
-**-**----**-------**----**----**-**-------**----**-**-------**-**-**----**-**-**-**----**----**-**----**-
-*****-********-********-**-*****-*****-********-**-**-**-**-*****-**-***********-**-**-*****-**-**-**-**-
----**-------**-------**-**-**----**----**-------------**-**----------**----**-------**-**----**-**-**-**-
-*****-********-********-********-**-*****-**-**-*****-***********-*****-**-********-**-*****-********-**-
-**-------**----------------------**-------**-**----**----**----**-------**-**-**----**----**----------**-
-*****-***********************-**-*****-**-*****************-*****-********-**-**************-**-********-
-**-**-------------**-**-**----**-**----**----------**----**----------**-------**-**-------**-**----------
-**-**-********-*****-**-**-*****-*****************-*****-********-***********-**-*****-*****-*****-*****-
-**-**-**-------**----**-**-**----------**-**-**----------**----**-------**-------------**----**----**----
-**-**-*****-**-**-**-**-**-*****-**-*****-**-**-**-*****-**-**-***********-**-***********-***********-**-
----------**-**-**-**----------**-**-------**----**-**----**-**-**-------**-**----**----**----**----**-**-
-*****-********************-*****-********-**-*****-********-***********-**-***********-**-**-*****-*****-
-**----**-**----------------**-------**-**-**-**-------------**-**-**-**-------**-------**-**----**----**-
-********-********-*****-********-**-**-**-*****-*****-*****-**-**-**-*****-********-*****-********-*****-
----------**----**-**----**-**-**-**-**-**-**-**-**-**-**-**-**-------**-**----------**----**-**-------**-
-**-**-********-*****-*****-**-********-*****-**-**-**-**-***********-**-********-**-********-**-**-*****-
-**-**----------**-------**-**-**-**-------**----**----------**----**-------**----**-**-**-**----**-------
-*****-**-********-**-*****-**-**-********-**-**-**-*****-********-*****-*****-*****-**-**-**-**-*****-**-
----**-**----**-**-**-**-**-**----------**----**-**-**-**----**-**-**-------**----**----**-**-**----**-**-
-*****-**-*****-********-**-***********-**-*****-**-**-*****-**-**-*****-*****-**-********-*****-**-*****-
-**-**-**----**-**----**----**----------**-**----**-**-**----**-**----------**-**-**----------**-**-**----
-**-*****-**-**-**-********-**-*****-********-********-**-*****-**-*****-*****-**************-***********-
-**-**----**-**----**-------**-**----**----**----------**-**-**----**-**-**-**----**-**-------**-------**-
-**-***********-********-***********-**-**-*****************-**-*****-**-**-**-*****-********-**-*****-**-
----**----**-------------------**-------**-**----**----**----**-**-**----**-**-------------------**----**-
-*****-*****-**-**-*****-**-**-**-*****-*****-********-**-********-**-**-**-********-*****-***********-**-
-**-**-**-**-**-**-**----**-**-------**----------------**-**-------**-**-------------**----**-------------
-**-**-**-**-*****-***********-*****************-********-**-*****-*****-********-**-**-**-***********-**-
-**----**-------**-**-**-------**----**-**-**-**----------**----**-**----**-------**-**-**-**-**-**----**-
-*****-**-**-********-**-**-**-**-*****-**-**-*****-**-********-**-*****-**-*****-***********-**-********-
----------**----**----**-**-**----------**----------**-**-------**-**----**----**----**----------------**-
-*****-**-**-*****-**-**-********-********-*****************-********-*****-*****-********-********-*****-
----**-**-**-------**-**-**-------**----**-**----**-------**-------**----**-**----**-**-**----**-**-------
-**************-**-*****-**-***********-**-**-*****-********-**-**-**************-**-**-*****-**-********-
-**-**----**----**-**-**-**-**-------**-**----**-**----------**-**-**-**-**-**-------**-**----**-------**-
-**-**-********-*****-********-**-*****-********-*****-*****-*****-**-**-**-**-**-*****-**-**-********-**-
-------**-------**----**-------**----------**-------------**-**----------**----**-**-**-**-**-**-**-**----
-**-********-*****-***********-***********-***********-**-**************-*****-*****-**-**-*****-**-*****-
-**-**----------------**-**----**-**-**----------**----**-**----------**-**-------**-------------------**-
-**-********-***********-**-*****-**-**************-*****-***********-*****-*****-**************-********-
-**----**----**-**----**----**-**----------**-**-**-**----**-**----------**-**----**----------**-**-------
-**************-*****-**-*****-***********-**-**-********-**-********-*****************-*****************
-------------------------------------------------------------------------------------------------------*$
