100 101
-#******-***********-*****-*************-***********-*********************-*********-*****-*******-*-
-*-------*-*-------*-*-----*-*---------*-*-----*---*-*-----*-------*-----*-----*---*---*-*---*---*-*-
-*******-*-*****-***-*-*****-*-*********-*****-*-***-*-***-*-***-*-*-***-*****-*-*-*-***-*-***-***-*-
-------*-*-----*-*---*-*-----*-----*-----------*-*-----*-*-*-*-*-*-*-*-*-----*-*-*-*-*---*-*---*---*-
-*****-*****-***-*****-*****-*****-*************-*******-*-***-***-*-*-*-***-***-*-***-*-*-***-***-*-
-*---*-----*-*---*---------*-----*-----------------------*-*-------*-*-*-*-*-----*-----*-*---*---*-*-
-***-*****-*-*-***-*******-*-***-*****-*-***************-*-*-*****-***-*-*-*********-***-*****-***-*-
-*-*-----*---*-*---*-----*-*-*-*-----*-*-*---*---------*-*-*-*---*-----*-*---*-*-----*-*-------*---*-
-*-*****-*****-***-*-***-***-*-*****-*-*****-***-***-***-*-*-***-*******-*-*-*-*-*****-*******-*-***-
-*-----*-----------*-*-*-----------*-*---------*-*-*-----*-*---*---------*-*-*---*-----*-----*-*-*---
-*-***-*-*****-*******-*****-*******-***-*******-*-*****-*-***-*****-*****-*-***-***-***-*-***-*-***-
-*---*-*-*---*-*-----------*-*-----*---*-*-------*-----*-*---*-----*-*-----*---*---*-*---*-*---*-*-*-
-***-*-*-*-*-*****-*****-*****-*******-*-*************-***-***-***-*-*********-*****-*-*****-*-*-*-*-
---*-*-*-*-*-------*---*-*-----*-------*-*-----------*-------*-*-*-*-------*---------*-*-----*-*-*-*-
-*-***-***-*****-***-***-*-***-***-***-*-*-*******-*********-*-*-*-***-***-*-*********-*-*****-*-*-*-
-*---*-----*---*-*---*-----*-*-----*-*-*---*-----*---------*---*-*---*-*-*-*-*---------*---*-*-*-*-*-
-***-*-*****-***-***-***-***-*-*****-*-*-***-***-***-*****-*****-*****-*-***-*********-*****-*-*-*-*-
-*-*-*-*-----*-*---*---*-*---*-*-----*-*-*---*-*-*-*-*---*-------------*-------------*-------*-*-*-*-
-*-*-*-*****-*-***-*-*****-*****-*******-*-*-*-*-*-*****-*-***********-*-***-*********-*******-*-*-*-
-*-*-*-----*-*-----*-------*-------------*-*-*-*---------*-----*---*---*---*-*---------*-------*---*-
-*-*-***-***-*****-***-***-***-*********-***-*-*********-*****-***-*-***-***-*****-***-*-*****-***-*-
-*-----*-*-----*-*---*---*-*---*-------*---*-*---------*-----*---*-*-*---*-------*-*-*-*---*-*---*-*-
-*-***-*-*-***-*-***-***-***-*****-***-***-*-*****-***-*-***-***-*-*-*-*-*******-***-*-*-***-***-*-*-
-*-*-*-*-*-*-*---*-*---*-----*-----*-*-*---*-----*---*-*-*-*---*-*---*-*-*---*-*-----*-*-*-----*-*-*-
-*-*-***-*-*-***-*-***-*-*****-*****-*-*********-*-***-***-*****-*****-*****-*-*****-*-*-*-*-***-***-
-*-*-------*---*-*-*---*-*-----*-----*---------*-*-*-----*---------*---------*-----*-*-*-*-*-*-----*-
-***********-*-*-*-*-***-***-***-*****-***-***-*-*-*******-*******-*-*********-***-*-*-***-***-***-*-
-*-----------*-*-*-*-*-----*-*-------*-*-*-*-*-*-*---------*-----*-*-*---------*-*-*-*---------*-*-*-
-***-*****-***-*-*-*-*****-*-*******-***-***-*-*-*****-*****-***-*-***-***-*****-*-*-***********-*-*-
---*-*---*-*-*-*---*---*---*-------*---------*-*-----*-*-----*-*-*-------*-*---*---*-------------*-*-
-*-*-*-***-*-*********-*-***-***-***-***-***-*-***-***-***-***-***-*******-*-*-***-*-*-*****-***-***-
-*-*-*-*---------------*-*-----*-*---*-*---*-*---*-*---*---*---------*-*---*-*---*-*-*-*-*-*---*-----
-***-*-*****************-*-*****-*****-***-*-*-*-*-***-*-***-*-*******-*-***-***-***-***-*-***-*****-
-*---*-----------------*-*---*-----------*-*-*-*-*---*-*-*---*-*-*-----*-*---*-*---------*---*-*-----
-*-*-*****-*************-***-***********-*-*-*-*****-***-*-*****-*-***-*-*****-*-*********-*-*-*****-
-*-*-----*-----------*-----*-*---*-------*-*-*-------*---*---*---*-*-*---------*---*-------*-*-*---*-
-***-***-*-*****-***-*-***-*-*-***-*******-*********-***-***-***-***-*********-*****-*******-*-*-*-*-
---*---*-*-*---*-*-*-*-*---*---*-*-*---------------*-------*---*---------*-*---------*-*-----*-*-*-*-
-*-*****-*-*-*-***-*-***-***-***-*-*************-*-***-*****-*-***-*****-*-***********-*-*****-***-*-
-*---*---*-*-*-----*-----*---*---*-------------*-*---*-*-----*-*---*---*-*---------*-----*-----*---*-
-***-*-***-*-*****-***-***-***-***-*********-***-*****-***-*****-***-*-*-*****-***-*****-***-***-***-
---*-*-*---*---*-----*-*---*---*-----*-----*-*-----*---*-*-------*---*-*-----*-*-*-----*---*---*-*-*-
-***-*-*-***-***-*****-***-*-*-*-***-***-***-*****-*-***-*************-*****-*-*-***-*****-***-*-*-*-
-*-*-*-*-*---*-*-*-------*-*-*-*-*-*---*---------*-*-------*-------------*-*-*-*---*-*---*---*-*-*---
-*-*-*-*-*****-*-*******-*-*-*-*-*-***-*-*****-***-***-***-*******-*****-*-*-***-***-***-*-*-*-*-***-
-*---*-*-------*-------*-*-*-*-*-*---*-*-*-*---*-----*-*-*-----*---*---*---*-----*-----*-*-*-*-*---*-
-***-*-*******-***-*****-***-***-*-***-***-*-***-*******-***-***-***-*-*****-*****-*-***-***-*-***-*-
-*-*-*-----*-*---*-*---*-----*---*-*-------*-*-------------*-*---*---*-------*-----*-*-------*---*-*-
-*-***-*****-***-*-*-*-*-*-***-***-*-*******-***-***-*****-*-*-***-***-*****-*-*****-***-*****-***-*-
-----*-*---------*-*-*-*-*-*---*---*-*-----*---*-*-*---*---*-*-*---*---*---*-*-*---*---*-*-----*---*-
-***-*-*********-*-*-*****-*-***-***-***-***-*-***-***-*-***-*-***-*******-*-*-*-*-*-***-*-***-***-*-
---*-*---------*-*-*-------*-*---*-----*-*---*-------*-*-*-------*-------*-*-*-*-*-*-*---*-*-*---*-*-
-***-*-***-***-***-*********-***-*******-***-*****-*-*-***-*******-*****-*-*-*-***-*-*****-*-*****-*-
-*---*---*-*-*---------------*-*-----*-----*---*-*-*-*-*---*-------*---*---*-*-----*-----------*---*-
-***-***-***-*****-*********-*-***-***-***-***-*-*-*-*-*****-*********-*****-*********-*******-***-*-
---*---*-----*-*-*-*---*---*-----*-----*-*---*-*-*-*-*-----------*---*---*-----------*---*---*-----*-
-*-*-*-*-***-*-*-*-***-*-*-*****-*-*****-*-*-*-*-***-*-***-*****-*-***-***-*********-*****-*-***-***-
-*-*-*-*-*-*-*-*---*---*-*-----*-*-*-----*-*-*-*-----*---*-*-*-*---*-------*-------*-------*---*-*-*-
-*-*-*****-*-*-***-*-***-*******-*-*-*****-*****-***-***-***-*-*****-*******-***-*-***********-***-*-
-*-*-------*-----*-*-*---*-------*-*-*-*---------*-*---*-----*---*---*-------*-*-*-----*-----------*-
-*-*******-*****-***-***-*****-*****-*-*-*****-***-*-***-*****-***-***-*******-***-***-***********-*-
-*-------*-----*-*-----*-----*-*-----*-*-*---*-*---*-*---*---*-----*---*---------*-*-------------*-*-
-*******-*-***-*-*****-***-***-*****-*-*-*-*-***-***-*-*****-*-*****-***-*******-*-*******-*****-*-*-
-----*---*-*---*---------*-*---------*---*-*-----*---*-----*---*-------*-*-------*---*---*-----*-*-*-
-***-*-***-*****-*********-***-*****-*-***-*****-*-***-***-*****-*******-***-*****-***-*-*****-*-*-*-
-*-*-*-*---*-----*-----------*-*---*-*-*---*---*-*-*---*-*-*-----*-*-----*-*-*-----*---*-----*-*-*-*-
-*-***-*-*-***-*****-*******-***-*-*-*-*-*-*-*-***-*****-*-*****-*-*****-*-*-*-*****-*******-*-*-***-
-*-----*-*---*-----*-*-----------*-*-*-*-*-*-*-----*-----*-----*-------*---*-*---*---*-----*-*-*-----
-*******-***-***-***-*******-*****-***-*-***-*******-***-*****-***-***-*-***-*****-*******-*-*-*****-
-*-------*-----*-*---*-----*-*-*-----*-*-*-------*-----*-----*---*-*-*-*-*---------------*-*-*-*---*-
-*-***-***********-*-***-***-*-*******-*-*******-***-*****-*-***-***-*-*-***************-*-*-*-*-*-*-
-*-*-*-------------*---*-*-*-*---------*-------*---*-*---*-*---*-----*-*-*---*---------*---*-*-*-*-*-
-***-*********-*-*******-*-*-***-*-***-*-*******-*****-*****-*-*****-***-***-*******-*-*-***-***-***-
-------------*-*-*-------*-----*-*-*-*-*---*-----*---------*-*-----*-------*-------*-*-*-*-------*---
-*********-***-*-*-*****-***-***-***-*-***-*****-*-*****-*-***-***-*****-*-*-*******-***-*-*******-*-
---*-------*---*-*-----*---*-*-----*-*---*-----*---*---*-*---*-*-*-----*-*-*-*-------*---*-*-------*-
-***-*****-***-***********-*-*****-*-***-*-***-*****-*-*-***-*-*-*****-*-***-*-***-*******-***-*****-
-*---*---*---*-----*-----*-*-----*---*-*-*---*-------*-*-*---*-*---*---*-*---*-*-*-----------*-----*-
-*-*****-***-*****-*-***-*-*****-***-*-*-***-*****-*****-*-***-*-***-***-*-*-***-***-*******-*****-*-
-*-*-------*-----*---*-*-------*---*-*-*---*-----*-*-----*-*---*-----*---*-*-------*-*-----*-----*-*-
-*-***-*********-*****-*******-*******-*-***-*****-*-*********-*-*****-*******-***-*****-*-***-***-*-
-*---*-*-------*-------------*-------*---*---*-----*---------*-*-*-----------*-*-*-----*-*---*-*---*-
-*****-*-***********-*******-*-***-***-***-*******-*-*****-*****-***********-*-*-*****-*****-*******-
-*-----*-*-----------*-----*-*-*-*-----*---------*-*-*---*-*---------------*---*-----*---------------
-*-*-***-***-*******-*-*-***-*-*-*-*****-*******-*-*-*-***-*-***-*********-*-***-***-*-*****-***-***-
-*-*-*-*-----*-----*-*-*-*---*-*-*-*-----*-----*-*-*-*-*-----*-*-*-------*-*-*---*-*-*-*---*-*-*-*-*-
-***-*-*-***-*-***-***-*-*****-*-*-***-*-*****-***-***-*-*****-***-*****-*-***-***-*-***-***-*-***-*-
-*---*-*-*-*-*-*-*-----*-------*-*---*-*-*---*-*-------*-*-----------*-*-*---*-*---------*-*-*-----*-
-*-***-*-*-***-*-***-*******-***-*****-*-*-*-*-*-*******-***-*********-*-***-*-*********-*-*-*-*****-
---*---*-*-----*---*-*-----*-*-*-------*-*-*-*-*-*-------*-*-*---*-----*---*-*-----*---*-*---*-*---*-
-***-***-***-***-***-*-*****-*-*-*******-*-*-*-*-*****-***-*-***-*-*******-*-*****-***-*-***-*-***-*-
-*---*-----*---*-*---*-*-------*-*-----*-*-*-*-------*-----*-----*-*-------*-----*-*---*---*-*---*-*-
-*-*******-*****-***-*-***-*****-***-***-*-*-*****-***-***-***-***-***-*-***-*-***-*-***-*-***-***-*-
-*-----------------*-*---*-*-------*-----*-*---*-*-*---*-*---*-*-----*-*-*---*-*-----*-*-*-----*---*-
-*****************-***-*-***-*****-*-***-*****-*-*-*****-*****-*-*******-*-*********-*-***-***-***-*-
-*-------------*-------*-----*-*-*-*-*-*-----*-*---------------*-------*-*---------*-*-----*-*---*-*-
-*****-*****-*-*************-*-*-***-*-*******-*****-***********-***-***-*******-*****-*****-***-*-*-
-----*---*-*-*---*-----------*-*-----*-------------*-*-------*---*-*-----------*-------*-------*-*-*-
-*********-*****-*************-*******************-*********-*****-*********************-*********-$-
---------------------------------------------------*-------------------------------------------------