45 67
#**----------------------------------------------------------------
***-*****-********-********-**-********-**-********************-**-
-**-**-**----**-------**----**-**-------**-------**-**-------**-**-
-*****-********-**-**-*****-**-********-***********-**-**-*****-**-
----------**----**-**----**-**-**-**----**-**-------**-**----**-**-
-*****-********-**-*****-********-**-*****-********-**-**-********-
-**-**----**----**----**-**-**----**----**----------**-**-------**-
-**-***********************-**-**-*****-*****-**-***********-*****-
-**----**-**----------**----**-**-------------**-**-**----**-**-**-
-**-**-**-***********-*****-*****-*****-***********-*****-**-**-**-
-**-**----------**-**----**----------**-------**----**-------**-**-
-**-*****-********-**-**-*****-*****-**-********-********-*****-**-
-**----**----**-------**-**----**-**-**----------**-**-**----**-**-
-********-**-********-***********-*****-**-********-**-**-*****-**-
-**-------**----**-**----**-**----**-**-**-**----------**-**----**-
-********-********-**-*****-**-**-**-**-*****-*****-*****-*****-**-
-**-**-**-**----------**-------**-**----**-------**----**----**----
-**-**-**-**-*****-*****-***********-**-*****-*****-**-**-**-*****-
-------**----**----------**-**-------**----------**-**-**-**----**-
-**-********-**************-***********-***********-*****-**-*****-
-**-**----------**-------------**-**----------**----**----**-**-**-
-**-********-**-**-**-**-**-**-**-*****-********-**-*****-*****-**-
-**-**-**----**----**-**-**-**----**----**-------**----**-------**-
-*****-**-***********************-*****-*****************-**-**-**-
----------------**----**----------**-**----------**-**----**-**-**-
-**-**************-*****-**-**-*****-**************-*****-********-
-**-**----------**-------**-**----**-------------**-------**-**-**-
-*****-**-*****-**-***********-*****************-********-**-**-**-
-**-**-**-**-**-**-**----**----**-**----**-------------------**-**-
-**-**-**-**-********-**-**-**-**-**-**************-*****-**-**-**-
-**----**----**-**----**----**----**----------**-------**-**-**----
-**-**-*****-**-**-********************-*****-********-**-**-*****-
-**-**-**-------**-------**-**-**-**----**-**-**-------**-**-**----
-********-*****-**-********-**-**-**-*****-**************-*****-**-
----------**-**-**----**----**-**----------**----**----------**-**-
-*****-**-**-***********-*****-**-**-*****-**-********-**-*****-**-
-**----**-**----**-**-------**----**----**-**----**----**-**-**-**-
-***********-*****-**-*****-********-**-*****-**-**-********-*****-
-**----**-------------**-**-**-**----**-**-**-**-------**----------
-*****-**-**-**-**-*****-*****-**-**-*****-********-*****-********-
-------**-**-**-**-------**----**-**----**----------**-**-**----**-
-*****************-********-**-**-*****************-**-********-**-
----**-------**-------------**-**-------------**-**-**-**-**-------
-*****-**************-*****************-********-**-**-**-********-
----------------------------------------------------------------**$