19 19
***-*****-*******-$
*---*---*-----*-*-*
***-***-*-***-*-*-*
--*---*---*-*-*-*-*
*-***-*****-*-*-***
*---*-------*-*----
*****-***-***-*-***
*---*-*-*-*---*---*
*-***-*-*-***-*****
*-*---*-*---*-----*
*-*-***-*-***-***-*
*-*-*---*-*-----*-*
*-*****-*-*****-*-*
*-------*-----*-*-*
***-*-***-***-***-*
--*-***-----*---*-*
*-*-***-***-***-*-*
*-*-------*-***-*-*
#************-*****