10 12
*-**********
*-**-*******
*-**----****
****-*******
*--*--*-----
*-**-*******
*-*--*------
*-*--******$
*-*--*------
#***********