37 55
#**----------------------------------------------------
************************-*****-*****-*****************-
----------**-------------**----**-**-------**-**-**----
-*****************-*****-********-*****-*****-**-**-**-
----------**-**-**-**-**-------------**----**-**----**-
-***********-**-*****-**-*****-***********-**-********-
-**-------**-**-**-**-------**-**-------**----------**-
-**-********-**-**-*****-**-*****-***********-**-*****-
-**-**-------**----**----**-**----**-**----**-**-**----
-**-**-**-********-**-**-********-**-**-***********-**-
----**-**----------**-**----**----**----**-------**-**-
-**************-**-**-*****-*****-**-*****-********-**-
-**-**----------**-**-**-**-**----------**----**-**-**-
-**-***********-**-*****-**-*****-***********-**-*****-
-**----------**-**----**----**-------**----------------
-**-*****-***********-********-**-**-********-*****-**-
-**-**----------------------**-**-**-**----------**-**-
-*****-**-**-********-**-*****-********-*****-**-*****-
-------**-**-**-**----**-------------**----**-**-**----
-*****-**-**-**-**-*****-*****-**-*****-**-***********-
----**-**-**-**-**-**-**-**----**-**----**-**-**-**----
-**-*****-*****-*****-********-**-********-**-**-**-**-
-**----**-**-**----------**----**-------**-**----**-**-
-***********-**-*****-**-*****-*****-*****-*****-*****-
-**-------**-------**-**-**-**-**----**-**-------**----
-*****-**-**-***********-**-*****-**-**-**-**-********-
----**-**-------**-**----**-------**----**-**----**----
-***********-**-**-*****-**-********-*****************-
----**-------**----**-**-**-**-------**----**----------
-*****-*****-*****-**-********************-**-********-
-**----**----**-**-------**----------**-------**----**-
-**************-**-********-**-***********-*****-**-**-
----**-**-**----------------**-**----**-**-**----**-**-
-*****-**-**-*****-********-**-*****-**-**-**-********-
-**-**----**-**----**-**----**----**-------**----**-**-
-**-**-**************-********-**************-*****-**-
----------------------------------------------------**$