53 79
#**----------------------------------------------------------------------------
******-***********-**-*****-********-***********************-********-********-
-**-**-**-**----**-**-**-**----**-**-**-**----**-**-**-------**----------**----
-**-*****-**-***********-*****-**-*****-*****-**-**-**************-**-********-
-------**----------**----**-**----**----------**----**-**-**-------**-**----**-
-**-**************-**-*****-*****-**-*****-**-*****-**-**-*****-********-*****-
-**-------**----------------**----**-**----**-------**----------**----**-**----
-********-**-**-*****-**************-***********-**-*****-**-*****-*****-*****-
----**-**-**-**----**----**-------**-**-**-**----**-**----**-**----------**----
-*****-*****-*****-**-**-*****-*****-**-**-********-**************-**-**-*****-
-------------**-**-**-**----------**-------**----**----**-------**-**-**----**-
-*****-********-**-********-*****-**-********-*****-**-**-**-**-**-**-********-
----**----------**-**-------**-**-**----**-**-**----**----**-**-**-**----------
-*****-*****-**-*****-**-**-**-**-**-*****-**-********-*****-**************-**-
-**-**----**-**-**----**-**----**----**----------**-**-**----**-**-------**-**-
-**-********-*****-**-*****-**-**-*****-********-**-*****-*****-**-**-********-
----**-**----**----**-**----**-**----------**-**-------**----**----**----**----
-*****-**-*****-*****************-*****-*****-********-***********-*****-*****-
----**-**-**----**----**----**-------**-**-**-**-**-**-------**----**-**-**-**-
-*****-**-**-**-**-**-*****-***********-**-**-**-**-**************-**-**-**-**-
-**-------**-**----**----------**-**----**-------------**-**----**----**-**----
-*****-**-********-*****-**-*****-*****-**-**************-**-*****-*****-*****-
----**-**----**-------**-**----**-**-------------------**-**-**-**----**----**-
-***********-*****-***********-**-**-**-**-********-*****-**-**-********-*****-
-**----**-------**----**-**-**-**----**-**-**-------------**-**----------**----
-*****-*****-***********-**-*****-***********-*****-**-**-**-**-**-**-**-**-**-
-------**-------**----**-------**-**-------------**-**-**----**-**-**-**-**-**-
-**-********-*****-*****-**-********-***********-**-********************-**-**-
-**-**----**-**----------**-------**-**-------**-**----**-------**----------**-
-*****-*****-*****-********-*****************-*****-**-*****-********-*****-**-
----**----**-**-------**----**----------**----------**----------**-**-**----**-
-*****-***********-***********-**-**-*****-********-*****-*****-**-***********-
-**----------**-**----------**-**-**-------**-**-**-**-------**-**-------------
-*****-**-*****-**-**-**-*****-**-**-*****-**-**-********-**-*****-**-********-
----**-**-**-------**-**-**-**-**-**----**-------------**-**----**-**-------**-
-*****-*****-********-*****-*****************-**-**-**-*****-*****************-
-**-------**-**-**-**-------------**----**----**-**-**-**-------**-**-**-------
-**-***********-**-*****-*****-*****-*****-********************-**-**-********-
-**-**----------**----**-**----------**-------**----------**-**-**----------**-
-**-********-**-*****-**-********************-**-*****-**-**-********-**-*****-
-------------**-------------------**----------------**-**-**----**----**-**----
-********-**-**-**-**************-**-********-**-*****-**-**-**-********-*****-
-**----**-**-**-**----**----------**-**----**-**-**----**----**-**-**----**-**-
-*****-***********-*****-*****-********-**-**-***********-********-*****-**-**-
-**----**-**----------**----**-**-**-**-**-**-**----**-**-**----**-------------
-*****-**-**************-********-**-**-*****-**-**-**-**-*****-**-********-**-
----------**----**----------**-**-------**-------**-**-**----**----------**-**-
-********-**-********-**-*****-**-*****-********-**-**-**-*****-**-***********-
-------**----**----**-**-**-------**----**-------**-**-**----**-**-**----**-**-
-**************-********-*****-**-********-**-********-***********-*****-**-**-
-**-------**-**----**----**----**-------**-**-**-------------**-**-**-**-------
-**-********-*****-***********-*****************************-**-*****-********-
----------------------------------------------------------------------------**$