80 121
#**----------------------------------------------------------------------------------------------------------------------
************-*****************-*****-**-***********-********-**-***********-*****-*****************-**-*****-**-*****-**-
----**----**----**----**----**----**-**-**-**----**-**-------**-**-**-**-------**----**-------**----**----**-**----**-**-
-**-**-**-*****-**-*****-***********-*****-*****-**-**-**-*****-**-**-*****-*****-**-********-********-***********-*****-
-**-**-**-------------**-**----**-**----**-------**-**-**-**-**-------**-**----**-**-**----------------------**----**----
-********-**-********-**-**-*****-********-***********-**-**-**-*****-**-***********-**-*****-**-**-**-*****-**-********-
----**-**-**----**-**-**-**-**-------**-**----------**-**-**-**-**-**-**----**----**-**-**----**-**-**----**-**----**-**-
-*****-**-**-*****-**-**-**-*****-*****-**-**-**************-**-**-**-*****-**-**-*****-**-**-**-**-**-**-*****-**-**-**-
----**----**-**-**----------**-------------**-**-------**----**-**-**----------**-**-**-**-**-**-**-**-**----**-**-**----
-**-***********-**-**-*****-**-***********-***********-*****-**-**-***********-**-**-********-*****-*****-**-**-**-*****-
-**-**----**-------**-**----**----------**----------**-------------**----**-**-**-**-**-**----**----**----**-**-**-**----
-*****-**-**-**-*****************-*****-**************************-*****-**-**-**-**-**-*****-*****-**************-*****-
-------**-**-**-**-------------------**----**-------**-**-**-**-**-**-**-**----**-**-------------**----------**----**----
-**-**************-*****-*****-**-***********-*****-**-**-**-**-*****-**-**-*****-***********************-**-***********-
-**----**----**-------**----**-**----**----**-**-------**----------**-**----**-**-**----**-------------**-**----**-**-**-
-**-**-*****-**************-*****-*****-********-********-*****-*****-*****-**-**-**-***********-********-********-**-**-
-**-**-**----**----------**-**-**----**-------**----**----**----**----------**-**-**-**----**----------------**-**-**-**-
-********-*****-**************-**-*****-********-*****-**-**-**************-**-*****-**-**************-*****-**-**-**-**-
-**-**-**-**-**-------------**----**----**-------**----**-**-------------**----**-**----------**-**-**-**-**----**----**-
-**-**-**-**-********-***********-**-********-**************-**-*****-********-**-**-**-**-*****-**-*****-*****-**-*****-
-**-**-------**-------------**----------**-------------**-**-**-**----**-**-------**-**-**-**-------------**-**-**----**-
-**-**-*****-*****-*****-***********-***********-********-********-**-**-********-**-*****************-*****-********-**-
----------**-**-**-**-------------**-------------**-------------**-**----------------**-**----**-**----**-------**-------
-**-**-*****-**-**-*****-*****-**-**-**-*****-*****-********-***********-*****-*****-**-**-*****-**-********-*****-**-**-
-**-**-**-**----**-**-------**-**----**----**----------**----------**-**-**-------**----**-**-------**-**-**----**-**-**-
-********-********-***********-**-**-*****-***********-*****-********-*****-********-**-**-*****-**-**-**-*****-********-
----**-------**----**----**-**-**-**----**----**----**-**----------**-**-**-------**-**-**----**-**-------**-------**-**-
-********-*****-*****-**-**-**-**-*****-*****-**-**-*****-***********-**-********-**-**-*****-********-*****-*****-**-**-
-**-------**----**-**-**-------**----**-**-**-**-**-**----**-**-------**-------**-**-**----**-**-------**----**----------
-********-********-*****-********-*****-**-**-*****-**-*****-*****-**-*****-*****************-**-**-**-**-**************-
----------**----------**-**-**----**----**----**-------**-------**-**-------**----**-**-**-------**-**-**-**-------------
-*****-**-**-*****-**-*****-**************-*****-********-**-**************-**-*****-**-*****-**-*****-**-*****-********-
-**----**-------**-**-**-**----**-------------**-------**-**-**----**----------**-**----**----**-**-**----**----------**-
-***********-***********-*****-*****-**-**-********-**-**-********-**-********-**-*****-********-**-********************-
-**-**-**-**-**----**----**----------**-**-**-**----**-**-**-**-------**-**-------**----**----------------------**----**-
-**-**-**-********-*****-*****-**************-**-**-**-**-**-********-**-********-**-*****-*****-**-*****-***********-**-
-**-**----------------**-**-**-**-------------**-**-**-**----------------**----**-**-**-------**-**-**-------**-**-------
-**-*****-**************-**-**-**************-********-**-**-***********-**-********-**-**-*****-**-***********-**-**-**-
-------**-**-**-------**----**-------**-**----**----------**-**----**----**-------------**-**----**-------**-------**-**-
-*****-**-**-**-***********-********-**-**-********-*****-**-*****-**-*****-*****-**-*****-**-*****-********************-
-**-**-------**-------**----**-**----**----------**-**-**-**-------**-**-------**-**-**-**-**-**-**-------**----------**-
-**-**-********-********-**-**-***********-********-**-********-********-**-***********-********-***********-**-********-
-**----**----**-**-**----**-**----**----**----------------**-**-**----**-**----------**----------**-**----**-**-------**-
-**-*****-*****-**-**-**-********-**-*****-**-********-**-**-********-*****************-***********-**-********-*****-**-
-**-**-**-**----**----**----------------**-**-------**-**-**-**-**----------**-**-**----**-**-**----------------**-------
-**-**-**-**-*****-*****-*****-*****-********-***********-**-**-********-*****-**-*****-**-**-*****-*****-**-*****-*****-
-**----**-**-**-------**-**----**-------**-**-**----**-**----**-------**-------**----**----**----**-**-**-**-**----**-**-
-*****-**-**-*****-********-*****-*****-**-**-**-*****-**-**-*****-*****-**-********-*****-**-********-**-**-*****-**-**-
-**----**-**-------------**-**-**-**-------**----**-**----**----**----**-**-------**-------**-------**----**----**----**-
-*****-**-**-***********-*****-**-**-*****-*****-**-**-**************-**-**-**************-**-***********-**-**-*****-**-
-**-**-------**-------**-**-------**-**----**-**----**----**-------**----**----------**-------------**-**-**-**----**-**-
-**-*****-*****-********-********-********-**-*****-********-**-*****-***********-***********-**-**-**-*****************-
----**----------**-**-**-**-**----**-**-**-**----------**-**-**-**-------**-**-**----------**-**-**----**----------------
-********-*****-**-**-*****-**-*****-**-**************-**-*****-**-**-*****-**-**-*****-**-********-********-*****-*****-
-**-**-------**----**-**-**-**----**----**----**-**----------------**-------**-------**-**-**----**----**-------**-**----
-**-**-***********-**-**-**-**-********-**-**-**-**-**-*****-**-**-**-*****-*****-***********-**-**-**-**-*****-*****-**-
-**----**-**----------**----**-**-**----**-**-**----**-**----**-**-**-**-**-**----------**----**-**-**----**----**-**-**-
-**-*****-**-*****-**-*****-**-**-**-**-**-********-**-********-*****-**-**-********-**-**-***********************-*****-
-**-**----**----**-**-**-**----------**-**----**----**----**-**----**-**----**-**-**-**----------**-**----**-------**----
-*****-**-**************-********-**-********-*****-********-**-***********-**-**-*****-***********-*****-********-*****-
-------**-**-------**-**----------**----**-**----**-**-------------**----**-**----**-------**-**-------**----------**-**-
-*****-*****-*****-**-*****************-**-*****-*****-*****-********-***********-*****-*****-**-**-**-**-***********-**-
-**-------**-**-**-------**-------**-**----**-**-------**----------**----------**----------------**-**----**----------**-
-**-*****-*****-*****-**-*****-*****-**-*****-**-***********-*****-**-*****-**-***********-********-**-**-**-*****-*****-
-**-**-**----**----**-**----**----**----------**-**-**-**-**-**-**-**-**----**-**-**----**----**----**-**-**-**----------
-**-**-********-***********-**-********-*****-*****-**-**-*****-********-********-**-********-*****-********************-
-**-------------**-**-**-**-**-**-------**-------**-**-**-**----------------**----**----**----**----------**-**-**-------
-**-***********-**-**-**-**-**-**************-*****-**-**-***********-**-**-*****-*****-**-*****************-**-*****-**-
-**-**-**----**-------**----------------**----**-------**-**-**-------**-**----------------**-------------**----**----**-
-*****-**-**-***********-*****-*****-**-*****-*****-**-**-**-**-**-********-*****-***********-**-**-**-**-*****-*****-**-
-**-**----**-**-**-------**----**-**-**-------------**-------**-**----**----**----------**-**-**-**-**-**-------------**-
-**-*****-**-**-********-********-*****-**-*****-*****-**-**-*****-***********-***********-*****-*****-***********-*****-
-**----**-**-**----**-------**----**----**----**-**-**-**-**-**-**-------**----------**----**----**----**----**-------**-
-*****-*****-**-**-********-*****-*****-**-*****-**-********-**-**************-********-********-*****-**-*****-**-**-**-
----**-**----**-**----**----**-------**-**----**-**-**----------------**----**----**-------**-**----**-**----**-**-**-**-
-**-**-**-**-*****-*****-*****-***********-**-**-**-**-**-***********-*****-*****-********-**-***********-********-*****-
-**-**----**----**-------**-------**-------**-**-**----**----**-------**----------------**----------**-**-**----**----**-
-**-**-********-***********-*****************-**-**-**-*****-**-*****-**-**-**-*****-**-**-*****-*****-**-**-***********-
-**----------**-**----**-**-**-**----**----**-**-**-**----**-**-**----**-**-**----**-**-**-**----**-**-------------**----
-********************-**-**-**-**-*****-***********************************-**************-********-*****-**************-
----------------------------------------------------------------------------------------------------------------------**$