61 91
#**----------------------------------------------------------------------------------------
******-**-*****-**-********-***********-**-*****************-***********-**-*****-********-
----**-**-**-**-**-**-**-------**-------**-------------**----------**-**-**-**----------**-
-**-**-**-**-********-********-***********-**-*****-**-***********-**-*****-**-***********-
-**-**-**----**-**----**----**-**-**-**----**----**-**----------**-**-------**-**-------**-
-*****-*****-**-**-*****-**-**-**-**-**-*****************-*****-**-*****-********-*****-**-
-**-**----**-**-**-------**----**----------**----**----------**-**-**-**----**-------**-**-
-**-**-********-**-***********-********-*****-*****-**-**-*****-*****-***********-********-
----**-**-**-------------**----------**-**----------**-**----**-**----**-------**-**-------
-**-**-**-*****-*****************************-**-**-**************-***********-**-**-**-**-
-**-**-**-**-**-**----**-**-**-**-**----------**-**-**-------**----**----------**-**-**-**-
-*****-**-**-**-**-*****-**-**-**-***********-*****-*****-*****-********-**-**-**-**-*****-
-**-**----**-------**-------------**-**-**----**----**-**-**-------------**-**----------**-
-**-**************-********-********-**-*****-*****-**-**-*****-*****-**-**-**-**-********-
-**-------------**-**----**-**----------------**----**-------**-**----**-**-**-**----**-**-
-***********-**-*****-*****-***********-********-*****-***********-*****-*****-*****-**-**-
-------------**----**-**-------**-**-------**----------**-**----------**-**----**-**-**----
-********-***********-**-**-*****-*****-*****-********-**-********-********-*****-*****-**-
-**----**----------**-**-**----**----------**-**----------------**-**-------**-**-**----**-
-**-**-**-********-**-**-********-**-*****-*****-*****-**-*****-**-*****-**-**-**-********-
----**-**-**-------**-**----**----**----**----**-**----**----**-**-**----**-**----------**-
-********-********-**-**-********-********-**************-********-*****-********-*****-**-
-**----**-**----**-------**-**-------**-------------**----**-------**-**-**-------**----**-
-**-***********-**-********-***********-***********-**-***********-**-********-********-**-
-**-**----**-------------------**-------**-------**-**-**-------**-**-**----**-**-------**-
-**-*****-***********-********-*****-*****-**************-***********-**-**-********-*****-
----**-**-**-------**----**----**-**-**----------**-**-**-**----**-**-**-**-------**-**-**-
-*****-**-**-**-*****-********-**-**-**-*****-*****-**-**-*****-**-**-***********-**-**-**-
-**----------**-------------**-**-**-**-**-------**----**-**----------**----**----**-------
-********-********-***********-**-**-**-**-***********-**-**-********-*****-**-**-**-*****-
-**----**----**----------**----**----**-**-------**----------------**-**----**-**-------**-
-*****-********-********-**-**-**************-**-*****-*****-********-**-*****-***********-
-------**----------**----**-**-**----**----**-**----**-**-**-**-**-**-**----**-------**-**-
-*****-*****************-**-********-**-**-**-*****-*****-**-**-**-********-***********-**-
-**-------------**----**-**-**-**-**----**-**----**-**-**-**----------**----**----------**-
-**-**-**-**-*****-**-**-**-**-**-**-**-***********-**-**-*****-***********-*****-********-
-**-**-**-**-**-**-**----**-**-------**-------**-------**-------------**----**-**----------
-**-**-**-**-**-*****-********-***********-********-*****-**-*****-**-*****-**-**-********-
-**-**-**-**-**-**----**----------**----------**-------**-**----**-**-**-**-------**----**-
-***********-**-**-********-********-*****-*****-*****-*****-**-********-*****-********-**-
-**----**-**-**-------**-**-------**-**-**-**----**-**-**----**-------------**-**-**-**-**-
-*****-**-********-*****-**-***********-*****-*****-**-*****-**************-**-**-**-**-**-
-**-------------**----**-------------**-------**----**-**-**----------**-------------**----
-*****-********-**-*****-**-********-**-*****-**-**-**-**-**************-********-*****-**-
----**-**-------**----**-**-------**-**-**-**-**-**----**-**----**----**-**-------**----**-
-*****-**-*****-********-*****-*****-**-**-**************-*****-*****-**-*****-**-********-
----**-**----**-**-------**-**-**----**----------**----**----**-**----------**-**-**----**-
-*****-*****-*****-**-*****-********-********-*****-*****-*****-*****************-**-*****-
----**----**-**-**-**-------**-------**-**----------------**-**-------**-------**----**-**-
-**-*****-*****-*****-**-********-*****-**-**-**-*****-*****-**-**-********-**-*****-**-**-
-**----**-------**----**-**----------------**-**----**-**-------**-**----**-**----------**-
-********-**************-********-*****-**-*****-*****************-*****-*****-*****-*****-
-**----**----------------**-------**----**-**----**-**-------------**-**-------**-------**-
-*****-***********-**-********-********************-********-*****-**-*****-********-*****-
-**-------------**-**-**-**-------**-**-**----**----**----**-**----**----**-**-**-**-**----
-**-**-*****-*****-**-**-**-*****-**-**-*****-**-*****-********-*****-**-*****-**-********-
-**-**----**-------**----**-**----**-------------------**----**----**-**----------**-**-**-
-*****-*****************-**************************-**-**-**-**-********-**-**-*****-**-**-
-**-**----**----**-------**----**-------------------**-**-**----**----**-**-**-------**-**-
-**-********-***********-**-**************-**************-***********-********-********-**-
----------------------------------------------------------------------------------------**$