92 139
#**----------------------------------------------------------------------------------------------------------------------------------------
*********-***********-**-**-********-*****-*****-**-**-*****-*****-********-********-***********-**-**************-***********************-
-**----**----**----**-**-**----**-**-**----**-**-**-**-**-**-**----------**-------**-**----**-**-**-**-**----**----**-**-------**-------**-
-*****-**-********-**-*****-**-**-********-**-*****-*****-***********-********-***********-**-**-**-**-**-**-*****-**-**-***********-*****-
----**-**----**-**-------**-**----**----------**-**-**-**-**-**-------**----------------**----**-**-------**----**-------**----**----------
-**-**-**-*****-**-*****-*****-**-*****-********-**-**-**-**-**-********-********-********-**************-*****-********-**-*****-********-
-**-**----------**-**-**-**----**-**-**-**----**----**----------**----**----**-**-------**----**-**-**----**----**----**-**-------------**-
-*****-**-********-**-**-*****-**-**-********-**-**-********-*****-***********-***********-**-**-**-********-**-**-********-**-**-********-
-**-**-**-**-**-------**----**-**----**-**-**-**-**-**-**-**-**-**-------**-**-------**----**-------**-------**----**-**-**-**-**-------**-
-**-********-**-**-********-********-**-**-**-*****-**-**-*****-********-**-**-**-********-*****-********-*****-*****-**-**-********-**-**-
-**-------------**----**-------**-**-**----**-**----**----------**-**----------**-**-**-**----**-**----**-**-**-**-------**-**-------**-**-
-********-***********-***********-********-**-*****-********-**-**-*****-*****-*****-**-********-**-**-*****-**-*****-********-***********-
-------**-**-------------**-------**-**----------------------**-**----**-**-**-------**-**----**----**-**----**-------------**----**----**-
-*****************************-**-**-***********-**-*****-*****-**-*****-**-********-**-*****-********-**-**-**-**-**-*****-*****-**-**-**-
-**----**----**----------**----**----**----------**-**-**-**----**-**----------**-**-**-------------------**----**-**----**-**----**-**----
-**-**-**-**-***********-**-*****-**-**-*****-**-**-**-**-*****-**-**-***********-********-**-********-********-**-**-*****************-**-
-**-**-**-**----**-**-**----**----**----**-**-**-**----**----**----------**-**-**----------**-**-------**-**-**-**-**-**-**-**----------**-
-*****-*****-**-**-**-**-*****-**-*****-**-**-*****-**-********-**-**-*****-**-*****-*****-********-**-**-**-**-********-**-**-**-********-
-**----**----**-**-------**-**-**-**----**-**----**-**-**-------**-**----**-------**-**----**----**-**-------**-------**-**----**----**----
-*****-**-********-**-*****-********-*****-**-**-**************-**-**-**-**-*****-********-**-*****-**-**-***********-**-**-**-*****-**-**-
----------------**-**-**-------**----**-------**----**-**-**----**-**-**----**----**-**-**----**----**-**-**-**----**----**-**-**-**-**-**-
-*****-**-**-*****-********-**************-********-**-**-**-***********************-**-**-*****-**-*****-**-*****-***********-**-********-
-**----**-**-**----**-------**----**-**-**-**-------------**-**----------**----**----------**-**-**-**-**----------**-------**----**-**-**-
-*****-**-*****-**-********-*****-**-**-*****-**************-*****-**-*****-**-**-***********-********-*****-**************-********-**-**-
-**-**-**----**-**-------------------**-------------------**-------**----**-**-------------**-------------------**-**-**-**----------**----
-**-***********-*****-**************-**-********-**************-**************-********************-**-*****-**-**-**-**-********-*****-**-
-**-------**-------**----**-------**-**-**-**-**-**-**-**-------------**-**-------**----**----**----**-**----**-------**-------**-------**-
-**-*****-***********-*****-**************-**-*****-**-**-**-**-**-**-**-**-**-*****-**-*****-***********-********-***********-*****-*****-
----**-------------**-**-**-**-**-**-**-**----**-**-**----**-**-**-**----**-**-**----**-**----**----------**-**-------**----**-------**-**-
-*****-********-********-**-**-**-**-**-*****-**-**-********************************-**-*****-*****-**-*****-**-*****-**-*****-********-**-
-**----**----**----**-------**-**-**----------**-**----**-**-------**----**----------**-**-------**-**-**----**-**----**-**-**----**-**-**-
-********-**-*****-**-*****-**-**-**-***********-**-*****-*****-********-*****-**-***********-**************-*****-*****-**-*****-**-**-**-
-**-**----**-------**-**-------**-------------**-------------**-**-------------**-**-------**-**-**-------**----**----**-------**-------**-
-**-**-***********************-**-***********-**************-**-**-*****-***********-**-**-**-**-*****-**-*****-*****-**-**-***********-**-
----**-**----**-**----**-------**----------**----------**----**----**----**-------**-**-**----------**-**-------**-------**-**-------**-**-
-*****-**-*****-**-********-*****-*****-*****-**-*****-**-********-*****-********-**-********-*****-**-***********-***********-********-**-
----**-**----**-**-**-**----**----**-**----**-**-**-------**-------**-**----------**-**-**-**----**-**-**----------**-------**-**-**----**-
-********-**-**-**-**-**-*****-*****-*****************-**-***********-**-***********-**-**-***********-********************-**-**-**-*****-
-**----**-**-------**-------**-------**----**-**-**----**----------**-**-------**-------**-**-------------**-**-------**-**-------**----**-
-**-*****-*****-********-*****************-**-**-********-*****-*****-**-**************-**-********-*****-**-**-********-**-**************-
----**----**-**----**-------**-**-------------------**----**----------------------**-------**----**-**-**-------------**-**-**----------**-
-********-**-*****-**-*****-**-********-*****-**-*****-**-*****-*****-**-**-*****-********-*****-*****-**-**-*****-*****-**-***********-**-
----------**-------**-**----**-**----------**-**-------**-**----**----**-**----**-**----**-**-**----**----**-**----**----------**-**-------
-**-*****-**-***********-**-**-*****-**-***********-**-**-***********-**-**-*****-*****-**-**-*****-*****-*****-**-**-*****-*****-*****-**-
-**-**----**-**-**-**----**-------**-**-**-**-------**-**----**----**-**-**-**----**----**----**----------**----**----**-------------**-**-
-**-*****-*****-**-**-**-********-*****-**-**-********-**-*****-**************-********-**-**-**-********-***********-**-*****-***********-
-**----**----------**-**-**----**----**-**-**----**-**-**----------**----**-**-------**----**-**-------**-**-**-**-**-**-**-**----**----**-
-*****************-**-**-**-**-********-**-**-*****-*****************-**-**-********-**-**************-**-**-**-**-*****-**-**-*****-*****-
-**-------**----**----**-**-**-------**----**----**----**-------------**-**----**-------**----**-------**----------**-------**----------**-
-********-**-*****-**-********-*****-**-********-**-**-**-***********-********-**-**-********-**-*****-*****-*****-********-*****-**-*****-
----------**-------**-**----**----**-**-------**-**-**----------**----**-**-------**-**-------**-**----**-**----**-**-**-**-**----**----**-
-**-**-*****-********-**-********-***********-********************-**-**-**-**-**-**-**-**-*****-**-*****-***********-**-********-********-
-**-**----**-**-**-**----------------------------**-**----------**-**----**-**-**-**----**----**-**-**----------**-------**-**----------**-
-**-*****-**-**-**-**-***********************-*****-**-**************-**-**-*****-**-**-*****-********-**-**-**-**-********-********-*****-
-**-**----**-------**----------**----**----------**----------**-------**-**----**-**-**-**-**-**----**-**-**-**----------------**----------
-*****-**-*****-********-********-**-********-**-*****-********-**-**-**-***********-*****-*****-********-**-***********-**-*****-********-
----**-**-**----**----------**-**-**----------**-**-------**----**-**-**----**-------**----**-**----------**-**-------**-**----**-**-**----
-***********-**-********-*****-********-***********-*****-***********-********-********-**-**-*****-***********-**-**-**************-*****-
----**-------**-**-**-------**-**----------**----------**----**----------**-------**----**-**-**-**-**-**-**-**-**-**-------**----**-**----
-*****************-********-**-**************-**-*****-*****-**-**-***********-***********-**-**-**-**-**-**-**-*****-*****-*****-**-**-**-
-**----**-**----**----------------**----**-**-**----**-**-------**-**-**-**-**----**-**-------------------**-------**-**----------**-**-**-
-**-*****-*****-*****-**-***********-*****-**-********************-**-**-**-********-********-********-**-**-*****-*****-***********-*****-
-**----**----**-**----**----**-------**-**-**-------------**-**-**-**-------------------**----**-**----**-**----**-**----**-**----**-**-**-
-**-*****-*****-**-**-**-********-**-**-**-***********-*****-**-*****-***********-**-**-**-*****-*****-**************-*****-**-*****-**-**-
-**-**----**-**----**-**-**-------**-------**----**-------**----**-**-**-**----**-**-**-**-**----------------**-**-**----**----------**----
-**-*****-**-**-**-**-*****-********-*****-*****-*****-********-**-*****-**-********-********-**-*****-********-**-**-**-*****-***********-
-------------**-**-**-**-**-**-**-**-**-**----**----------**-**-------**-**-**-**----------**-**-**----**-------------**----------------**-
-*****-**************-**-*****-**-**-**-*****-********-*****-*****-**-**-**-**-**-*****-********-********-*****-********-*****************-
----**-------**-**-------------------**----**----**----------------**----**-**----**-**----------**-------**----**----**-------**----**-**-
-**-*****-**-**-**-**-**************-**-***********-**-********-*****-*****-**-**-**-*****-***********-**-*****-*****-*****-**-**-*****-**-
-**-**-**-**-**----**-**-**-------**-**-------**----**-**----------**-**-**----**-**----**----------**-**-**-**----------**-**-**-**----**-
-*****-**-**-*****-*****-**-*****-*****-*****-*****************-********-**-*****-*****-***********-*****-**-**************-*****-*****-**-
-**-------**----**----**-**-**-------**----**----**-------------**-**----------**----**-------------**-------------------**-**-------**-**-
-********-**-**-**-**-**-********-*****-**************-**-*****-**-**-********************-**-*****-***********-*****-**-*****-********-**-
----**-**-**-**-**-**----**-**-**-**-------------**-**-**-**-------------**----**-**----**-**-**----**----**-**-**----**----**-------------
-*****-**-*****-**-********-**-**-**-**************-********-*****-**-*****-*****-**-********-********-*****-**-***********-**-**-**-*****-
----**-------**-**-**-------**----**----------**----**-------**----**----**----------------**-**-------**-**----**----**----**-**-**----**-
-********-*****-********-********-**-********-**-*****-**-********-**-**-*****-***********-***********-**-**-********-********-*****-**-**-
-**-------**-**-**----------**----**----**-**----**-**-**-**----**-**-**-**-**-------**-------------**-**----------------**----**----**-**-
-**-********-***********-*****-*****-*****-**-**-**-********-**-**-********-**-**-**-**-*****-********-**-********-***********-**-**-**-**-
-**-**----------**-------------------**-**----**-**----------**----**-------**-**-**-**----**-**-**-**-**----**-**----**-------**-**-**-**-
-***********-**-***********-**-**-*****-**-*****-**-**-*****-**-*****-********-*****************-**-**-********-*****-*****-*****-*****-**-
-**-------**-**-**-**-**----**-**-**-------**-------**----**-**-**-------------**-**-**-------------**----**-**-**-**----**----**----**-**-
-**-*****-**-*****-**-***********-**-***********-***********-*****-**-*****-*****-**-**-*****-**-*****-**-**-**-**-**-**-**-**************-
-**-**-**-------------**-**-------**----**-**----------**-**----**-**----**-**----------**----**----**-**-**----**-**-**----**----**----**-
-*****-**-**-**-*****-**-*****************-*****-********-**-***********-**-**-**-*****-*****-**-*****-*****-**-**-********-*****-**-*****-
----------**-**----**-**----------**-**-**----**-------**-**-**----**----**----**-**----**-**-**-**-**-------**-**----**-------**----**-**-
-**-********-**-***********-*****-**-**-**-**-*****-*****-**-**-*****************-*****-**-********-********-********-**-**-**-**-**-**-**-
-**-**-**----**-**-**----------**-**-------**-**-**-**----**-------**-**-**----------**-**-**-**-**-------**-------**----**-**-**-**-------
-*****-***********-*****-**-***********-**-*****-*****-**-**-********-**-**-***********-**-**-**-**-**-*****-*****-***********************-
----**-------**----**----**-------**----**-**-**-**----**----------**-**-**-**-------**-**----------**----**-**----**-------**-------**----
-********-*****-**************-***********-**-**-********-***********-**-********-*****-**************-*****-***********-*****-***********-
----------------------------------------------------------------------------------------------------------------------------------------**$