***----------------------------------------------------------------------------------------------------------------------------------------------------
***-**-*****-**-*****-********-**-*****-********-********-********-*****-*****-*****-*****-********-***********-********-**-**-***********************-
-**-**-**----**----**-**----**-**-**----**-------**-**----**-**-------**-**----**----**----**----------------**----**-**-**-**-------**----**----**----
-********-********-********-*****-**-***********-**-********-**************-**************-***********-*****-********-********-**-********-**-********-
-**----**-**-**-**----**----**-**-**----**-------------**-------**----------**-------**-------------**-**----**----**-**----**-**----**----------**-**-
-*****-*****-**-**-*****-**-**-********************-*****-**-**************-********-**-**-**************-********-**-**-*****-********-***********-**-
-**----**-**----**-**----**-**----**-------**-**----**-**-**-**-------**----**-**-**----**----**----**-**----**-------------**----------------**-------
-*****-**-*****-**-********-**-**-**-********-*****-**-**-*****-***********-**-**-********-**-*****-**-*****-*****-********************************-**-
-------**-**-------------------**----**----------------**----**-------**-**-**-**----------**----**----**-------------**----------**----------**----**-
-********-********************-**-***********-**-**-**-**-**-**-*****-**-*****-********-*****-*****-*****-*****-*****-*****-*****-**-***********-**-**-
-**-**----**----**----**-**----**-------**----**-**-**-**-**-------**-**----------**-**-**-**-------**----**-------**-**----**-**-**-**----**-**-**-**-
-**-**-**-**-**-*****-**-*****-********-********-***********-**-*****************-**-*****-*****-***********-*****-**-********-**-**-*****-**-********-
----**-**-**-**-**----**-**----**-------**-**-**-**-**-**-**-**-------------**----------**-**-------**----**----**-**-**-**----**-------**-**-**-**-**-
-********-**-*****-**-**-********-*****-**-**-*****-**-**-**-**-**-********-**-**-*****-**-********-**-**-**-**-********-**-********-*****-**-**-**-**-
-**----**----------**----**-**-------**-**-------**-**-**-**-**-**----**-**-**-**-**-------**-**-------**-**-**-------**-**-------**----**----**-**----
-*****-**-*****-**-********-**-********-*****-**-**-**-**-*****-*****-**-*****-**-**-********-**-*****-**-**************-**-********-**-*****-**-*****-
-**----------**-**----**-------**-------**----**-------**----------**----------**-**----------**-**----**----**-**-**-**----**-------**-**-**-**----**-
-********-********-***********-********-***********-**-*****-********-**-**-***********-***********-*****-**-**-**-**-**-**-***********-**-**-*****-**-
-**-**----------**-**-**-**----------**-**----------**-**----------**-**-**-**-**----------------**-**-**-**-**-**-**-**-**----**-**-**-**----------**-
-**-*****-**-**-*****-**-*****-********-*****-*****-*****-*****************-**-**-***********-*****-**-********-**-**-*****-**-**-**-**-**-***********-
-**-**-**-**-**-**-**-------------**----**-**-**----**-**-**-------------------**----**-**-**-------**----**-**-**-**-------**----**-**-**-**----------
-**-**-**-*****-**-**-***********-********-**-**-**-**-*****-*****-**************-**-**-**-********-*****-**-**-**-**-*****-********-**-**-**-*****-**-
----**-**-**-**----**-------**-**-------------**-**----**-**-**-------------**-**-**-------**----------**----**----**-**-**----**----**----**-**-**-**-
-*****-**-**-********-*****-**-**-********-**-*****-*****-**-***********-*****-**-**************-*****-**-*****-**-**-**-**-*****-**-**-********-*****-
----**----------**-------**----**-**-**----**-**-------**-------**-------------**----**-**-------**----------**-**-------**-------**----------------**-
-********-***********-**-***********-**-********-***********-*****-**************-*****-*****-********-*****************-*****-**-**-********-**-*****-
----**----------**----**-**-**-------**-**----**-**-------**----**-**----------**----**-------**-------**----**-**-------**-**-**-**-------**-**-**----
-**-*****-**-**-**-**-**-**-**-*****-**-**-*****-**-*****-*****-**-***********-***********-**-**-***********-**-*****-*****-*****-*****-********-**-**-
-**-**----**-**-**-**-**-**----**-------**----**-**----**----**-**-**----**----**----**----**-**-**-**-**-**-**-------**-**----**-**-**-**-**-------**-
-*****-********************-********-**-**-**-**-**-**-********-********-*****-**-*****************-**-**-**-*****-*****-*****-**-**-*****-*****-*****-
-**-**-**----**----**----**-**-------**----**-**-**-**----------**-**-------------**----**-**-**----**-**----**----**-**----**----**----------**----**-
-**-**-*****-**-*****-**-***********-**************************-**-**-**-**-*****-**-*****-**-**-**-**-*****-*****-**-*****-**-**-**-********-********-
-**-**-**-**----------**-------------------------**----**-**----------**-**----**-------**-**----**----**----**----**----**----**-**----**-------------
-**-**-**-**-**-*****-*****-**-*****-**-***********-*****-**-**-********-********-********-**-********-*****-**-********-***********-*****-***********-
-**-------**-**----**-**-**-**-**-**-**-**-**-**----**-**----**----**----**----**-**----------**----**-------**----**-**-**----------**-**----**-**-**-
-*****-*****************-********-**-*****-**-**-**-**-********-*****-*****-**-**-**-**-***********-********-**-*****-**-**************-**-**-**-**-**-
-**-**-**----**----**----**----**-------**-**----**-**-**-**-------**-**----**-------**----**----**----**----**----**-**----**----------**-**-------**-
-**-**-**-**-**-********-**-***********-**-********-**-**-***********************-***********-**-**-*****-*****-*****-**-********-***********-**-*****-
-**-------**-------------**----------**----------**----**----------**----------**----**-------**-**----**-**-------**-**----**----**-------**-**-**----
-**-**-********-**-***********-**************-********-**-***********-**-**-**-**-**-**-**-*****-**-**-**-********-**-*****-**-**-*****-**************-
----**-**----**-**-------------**-------**-------**----------**-------**-**-**----**-**-**-**-**----**-------**----**----**-**-**-**-**-------**-**----
-**-*****-**-*****-*****-**-**-*****-*****-*****************-**-********-*****************-**-*****-*****-********-**-*****-*****-**-********-**-*****-
-**-**-**-**-**-**----**-**-**-**----------**-**-------------**----**-------------------**----**-**-**-------**-**----------**-**-------------**-**-**-
-*****-**-*****-**-*****************-*****-**-**-**-**-*****-**************-**-***********-*****-**************-*****-*****-**-**-***********-**-**-**-
-**-------------**----**----**-**----**-**----**-**-**----**-------------**-**-**-**----------**-**-------**-**----**-**----**----**-**-**-**-**-------
-*****-*****-********-*****-**-**-*****-*****-********************-**-**-**-*****-***********-**-*****-*****-*****-*****-*****-**-**-**-**-***********-
-**----**-**----**-**-**----**----------**----------------**-**----**-**----**-------**-------**-------**-**----------**-**-**-**----------**-**-**-**-
-*****-**-**-*****-*****-***********-*****-*****-********-**-**-**-**-**-**-**-**-********-**-*****-*****-**-*****-********-********-*****-**-**-**-**-
-**-------**-------------**----------**----**----**----**-**-**-**-**-**-**-**-**-**-**----**-------------**----**----**-------------**----------------
-********-*****************-***********-********-*****-*****-**-***********-*****-**-**-**-***********-*****-**-********-**-**-********-*****-********-
-**-------**-**-**-**----**-**-------**-**-------------------**-**-**-**----**-**----**-**----**----**-------**-**-**----**-**----**----**-**-------**-
-**-*****-**-**-**-**-***********-*****-***********-***********-**-**-*****-**-**-**-********-*****-**-**-**-**-**-***********-**-********-**-********-
-**-**----**-------**----**----**----**-**-------------**-**-**-**----**-------**-**----**----**-------**-**-**----------**-**-**----**-------------**-
-**-*****-**-***********-**-*****-*****-*****-********-**-**-********-**-*****-**-*****************-**-**-***********-*****-********-*****************-
-------**----**----**----------**-**----**----------**----**----**----------**----**----------**----**-**-**-------**----**-**-**-------------**-**-**-
-*****-**-*****-***********-*****-********-**-**************-**-**-***********-*****-**-*****-**-**************-*****-**-**-**-********-**-*****-**-**-
-**----**----**-**-------**----------**----**-**-------**----**-**----------**-**----**----**----**----------**-**-**-**-**-------------**-------**-**-
-***********-**-*****-**************-********-**-***********-**-*****-***********-**-*****-********-*****-**-**-**-*****-*****-**-**-*****-**-*****-**-
-**-------------**-**----------**-------**----**----**-**----**-**----**----**----**----**-**----**----**-**-------**-------**-**-**-**-**-**-**-**-**-
-***********-**-**-*****-**-***********-**-********-**-*****-*****-********-********-***********-**-*****-**************-**-*****-**-**-*****-**-**-**-
-**----------**-**----**-**-**----**----------**-------**----**-**----------**----**-------**----**-**----**----**-------**-**----**-**-**----**-**----
-********-***********-*****-*****-**-**-**************-**-*****-*****-*****-**-**************-**-*****-**-**-**-**************-*****-**-********-*****-
-------**-**----------**----**-------**----**-**-**-------**-------**-**----**----**----------**-**----**----**-**-------**----**-------**-------**-**-
-*****-********-**-**-**-********-*****-*****-**-********-**-**************-*****-**-********-**************-*****-***********-*****-***********-**-**-
-**----**-**-**-**-**----**-**-**-**-------------**----------**-------------**-------------**-**-**-------------**-**-**-**----**-**-**----**-------**-
-********-**-***********-**-**-**-*****************-***********-*****************-*****-********-*****-**-*****-**-**-**-**-*****-********-**-**-**-**-
-**----**-**----------**-------**-**----**----**----**-------------**-**----**-------**-------**-**-**-**-**-**-**-------------------**----**-**-**-**-
-**-*****-**-********-*****-**-*****-**-**-**-**-********************-**-**-********-**-**-*****-**-**-*****-**-**-*****-**-***********-*****-**-**-**-
-**-**-**-------**-**-**----**----**-**----**----**----**-------------**-**----------**-**----**-**-------**----------**-**----------**-------**-**-**-
-**-**-**-*****-**-**-**-*****-*****-********-********-*****-**-*****-**-***********-*****-**-**-**-*****-**************-********-********-********-**-
-**----**----**-**-------**----**----**-**-------**----**-**-**----**-**----**-**-------**-**-**-------**-**-**-**-**-**-**-------**----**----**----**-
-**-**************-**************-*****-********-*****-**-*****-**-*****-*****-********-********-**-**-*****-**-**-**-**-*****-**-**-**************-**-
-**-------**-**-**-------------------------**----------**----**-**-**----------------**----**----**-**----**-------------**----**----------------**----
-*****-*****-**-*****-**-*****-*****-*****-*****-**-**-**-**-*****-**-*****-**-**-**************-**-***********-**-*****************-**-*****-********-
----**----**-**-**----**-**-------**----**----**-**-**-**-**----**-**-**-**-**-**----**----**-**-**-**----**----**-**----**-------**-**----**----**----
-********-**-**-**-***********-********-**************-**-********-**-**-**-**-********-*****-*****-*****-**-********-***********-**************-*****-
-**----------**-------**----**----**-------**----------**----**----------**-**-**-**-**-------------------**----------------------------------**-**----
-**-**-*****************-********-**-*****-**************-********-**-*****-**-**-**-*****-*****-**-*****-**-***********-********-*****************-**-
----**-------**----**-**-**-**-**-**-**-**-**-------**-------------**-**-**-**-**-**----**-**----**----**-**-**-**----------**-------**----**----**-**-
-*****-********-*****-**-**-**-*****-**-*****-********-**-**-**-*****-**-**-*****-*****-**-********-*****-*****-**-********-**-**-*****-********-*****-
-**-------**----------**----**----------------**----**-**-**-**----**----**----------**----**----**----**-**----**-------**-**-**----------**----------
-**-*****-*****-*****-*****-**-********-**-*****-**************-**-********-**-***********-**-**************-*****-*****************-**************-**-
-**-**-**-**----**----------**-------**-**----**----**-**-**-**-**----**-**-**-**-**-------**----------**-**-**----**----**----**-------**----**----**-
-*****-**-***********-********-********-*****-**-**-**-**-**-*****-*****-********-*****-*****-**-********-**-**-*****-**-**-********-*****-*****-**-**-
-**----------------------**----**-**-------**-**-**-**----------**-------------------**-------**----------**-**-**----**-**-------------------**-**-**-
-********-*****-*****-*****-**-**-***********-**-*****-********-***********-*****-********-*****-**-********-**-********-********-**-**-***********-**-
----**-**-**-------**-**----**----**-**----**-**----**----**----**-**-------**-**----**-**----**-**----**-------**----------------**-**-**-**-**-**-**-
-*****-********-***********-********-*****-**-*****-**-*****-**-**-***********-**-*****-*****-**-*****-***********-**-*****-*****-**-*****-**-**-**-**-
----------**-**-**-**-**-------**-**-**-------**----**-**----**----**-**----------**----**-**-**-**-------------**-**----**-**-**-**-**-------**----**-
-*****-**-**-*****-**-**-********-**-**************-***********-*****-**-*****-**-*****-**-*****-**-*****-**-**-**-**-*****-**-********-**************-
----**-**----**-------------**-------**----**-**-**-------**----------**-**-**-**-**-------------**----**-**-**-**-**----**-**-**----**----**-------**-
-********-**-**-*****-*****-********-**-**-**-**-*****-********-**-*****-**-*****-***********-**-********-********************-**-*****-*****-*****-**-
----**----**-**----**-**-**-------------**-**-------**----**-**-**-**-------**----**-**-**----**-**----**-**-------------**-**-**----**-------**-**-**-
-*****-********-*****-**-*****-**-**************-********-**-*****-**************-**-**-**-***********-**************-*****-**-**-**-**-**-**-**-*****-
-**-**-------------**-------**-**-------**----**-------**-**-------**-------------**----**-**----**-**----**----**-**-------------**----**-**-------**-
-**-*****-***********-**-*****-**-***********-**-********-**-**-**-**-**-**-***********-**-*****-**-**-*****-*****-*****-*****************-*****-**-**-
-**----**----------**-**----**-**-**-**-**-**----**-------**-**-**----**-**-------**-------**-------**-**-------**----**----**----**----**----**-**-**-
-*****-***********-*****************-**-**-**-**-********-**************-***********************-*****-********-**-**-**-*****-**-**-*****-***********-
-**----------**-**----**-**-**-------**----**-**-**-**----**-**-**-------------**-**-**-------**-------**-------**-**-**-------**----**-**-------**-**-
-*****-********-********-**-**-********-********-**-*****-**-**-**-**************-**-**-***********-********-*****-********************-**-********-**-
----------------------------------------------------------------------------------------------------------------------------------------------------**$