25 25
#**-------------------------------------------------------------------------
***-********-**-**************-**************-********-**-**-**-*****-*****-
-**-**-------**-------**----**-**-------------**-------**-**-**----**-**----
-***********-********-*****-*****-**************-*****-********-********-**-
-**-**-------**-**-**----------**----**-------------**-------**-**-------**-
-**-***********-**-*****-*****-********-**-**-*****-**-*****-***********-**-
----------**----**----**----**-**-------**-**-**----**-**----**----------**-
-**-**-********-**-*****-*****-********-**-*****-**-**-**-********-********-
-**-**----**-**-------------**-------**-**-**----**-**-**----**----**-**-**-
-**-**-*****-**-**-*****-**-**-***********-***********-**-**-********-**-**-
-**-**-**----**-**-**----**-**-**----------**----**----**-**-------**-------
-***********-**-***********-*****-**-*****-**-*****-*****-********-********-
-**----**-------**-**-------**-**-**----**-**-**-**-**----**----------**-**-
-*****-*****-*****-*****-**-**-**************-**-***********-***********-**-
-**-------**-------**----**----**-**----**-**-**-------**-**----**-------**-
-*****-**-********-**-********-**-**-**-**-**-********-**-*****-*****-*****-
-**----**----**----**-------**----**-**-------**-**----------**----**-------
-***********-********-*****-**-*****-**-********-**-***********-***********-
-------**-------------**----**-------**-------------**-------**-**-**-**----
-**-*****-*****-**-**************-***********-**-*****-***********-**-*****-
-**-**-------**-**-------------**----------**-**-------**-------**-------**-
-**-********-********-**-********-**-********-**-**-**-********-**-********-
-**-------**-**-**----**-**-------**-**-**----**-**-**-**-**-------**----**-
-**-*****-**-**-**-**-*****-*****-*****-*****-**-*****-**-**-**-*****-*****-
-**-**-**-**-**----**-**-**-**----**----------**----**-**-**-**-**-------**-
-*****-********-********-**-**-***********-**************-*****-**-********-
-**-**-------**-**-------**-**-------**----**----**-**-**----**-------**-**-
-**-*****-**-**-**-*****-**-***********-**-**-**-**-**-*****-**-**-**-**-**-
----**-**-**----------**-**-**-------**-**----**-**----**-**----**-**----**-
-**-**-**-**************-********-********-********-**-**-***********-*****-
-**-**-------**-------------**-**----**-**-**----**-**-------**-**-------**-
-********-*****-*****-**-*****-**-*****-********-**-********-**-**-*****-**-
----**-------**-**----**-**-------------**----------**-**----**-**-**-------
-********-***********-********-**-**-**-**-***********-********-**-**-*****-
-**----**-**-------**-**-------**-**-**----**-**-------**-------**-**-**----
-*****-*****-********-*****-***********-*****-**-********-********-********-
-**----------**----**-------**-------**-**-------------------**-**-**-**----
-********-**-*****-*****-********-**-*****-**-**-*****-**-*****-*****-*****-
----------**-**----------------**-**-------**-**----**-**-**-**----**-------
-**-********************-**-*****-**-**-*****************-**-**-***********-
-**-**-------**-**----**-**-**----**-**-------**----**-------**-------**----
-**-**-**-**-**-**-***********-**-***********-**-*****************-**-*****-
-**----**-**----------**----**-**-**----**-------------**----------**-**----
-**-**-**-***********-**-*****-**-**-********-***********-*****-***********-
-**-**-**-**-------**----**-**-**----------**-**----------**-------------**-
-**-********-*****-**-*****-**-**-**************-*****-**-*****-***********-
-**-------**-**-------**----**-**----**-------**----**-**-**-**-**----**----
-********-**************-**-**-*****-**-********-*****-**-**-**-*****-**-**-
-**-------**-**-**-------**-**-**-------------**-**-**-**-**----**-------**-
-***********-**-***********-***********-***********-*****-*****************
-------------------------------------------------------------------------*$
