99 101
-#******-***************-*-*******************-*****-***********************-***-***-*********-*****-
-*---*---*---------*---*-*-*-------*---------*-*---*-*---------------*-----*-*-*-*---*-----*-*-*---*-
-***-*************-*-*-*-*******-***-***-***-*-***-*-*-*-***********-*****-***-***-***-*****-*-***-*-
---*-------------*-*-*-*-------*-*-*-*-*-*-*-*---*-*-*-*-*---*-----*-----*---------*---*---------*-*-
-*-*-*****-*******-*-***-*****-*-*-*-*-***-*-*****-*-*-***-***-*-*****-***-***-***-*-*-*-*******-*-*-
-*-*-*---*-------*-*-*---*---*---*-*-*-----*-----*---*-*---*---*-*-----*---*-*-*-*-*-*-*-*---*---*-*-
-***-*-*-*******-*-*-*****-***-***-*-*-***-*****-*-***-***-*-***-*-*-***-***-***-*-***-***-*-*-***-*-
-*---*-*-------*-*-*-------*---*---*-*-*-*-----*---*-------*-*-*-*-*-*---*-------*---*-----*-*-*---*-
-***-*-*******-*-*-*-*****-***-*-***-*-*-*****-***-*-*******-*-*-*-*-*****-***-***-*-*-*****-*-*-***-
---*-*---*---*-*---*-*-*-----*-*-----*-*---*-----*-*---*-----*---*-*-------*-*-*-*-*-*-*---*-*-*-*---
-***-***-***-*-*****-*-*********-*****-*-***-*****-***-*-*-*****-*-***-*****-*-*-***-*-***-*-***-***-
-*-----*---*-*-------*-----------*-----*-----*-------*-*-*-*---*-*-*-*-*-*-----*-----*-*-*-*-------*-
-***-***-***-*******-*****-*******-*****-***-*-*****-***-*-*-***-***-***-*-***-*-*****-*-*-*******-*-
---*-*---*-----*---------*-*-------*-*---*-*-*-*-*-*-----*-*-*-----*-------*-*-*-*-----*-*-------*-*-
-*-*-***-***-***-***-*****-*-*****-*-*****-*-***-*-*-*****-*-*******-*****-*-***-*-*-***-*-*****-*-*-
-*-*---*-*-*-----*-*-*-----*-*-----*-------*-----*---*-*---*---------*---*-*---*-*-*-*---*-*---*-*-*-
-***-***-*-*******-***-*****-*****-*-*******-***-*****-***-***-***-***-***-*-***-*-***-***-***-***-*-
-----*-*-----*---------*-------*-*-*-*-------*-*---------*---*---*-*---*---*-*---*-----*-----*-----*-
-*****-*-***-***-***-***-*****-*-***-*****-***-***-*****-*-***-***-***-*-***-*-*-*****-***-*-***-***-
-*-----*-*-*---*-*-*-*-----*-*-----*-----*-*-----*-*---*-*-*---*-----*-*---*-*-*-----*---*-*---*-*---
-*-***-*-*-*-***-*-***-*****-*****-*****-*****-***-*-***-*-*-***-*****-*****-*****-*-*-***-*****-***-
-*-*-*---*-*---*-*-----*---------*-*-----------*-*-*---*-*-*---*-*---------------*-*-*-*-----*-----*-
-***-*-***-***-*-*-*-***-*******-*-*-***********-*-***-***-*-***-*-***************-*-*-*****-*-*****-
-*---*-*-----*---*-*-*-*-----*---*-*-*-----------*---*-----*-*-*-*-*-----------*---*-*-----*-*-*---*-
-***-*-*-***-*-***-***-*****-***-*-*-*****-***-***-*-*****-*-*-*-*-*-***-*****-*****-*-***-*-*-*-***-
-----*-*-*-*-*-*-----------*---*-*-------*---*-*---*-----*-*-*---*---*-*-*---*-------*-*-*-*---*-*---
-***-*-*-*-*-*-*-*********-***-***********-***-*-*-*****-*-*-***-*****-***-*-*******-***-*-*-***-***-
-*-*-*-*-*-*-*-*-*-------*-*-*-------------*---*-*-*-*-*-*-*---*-----------*-------*-----*-*-*-*-----
-*-***-*-*-*-*-*-***-***-*-*-*******-*****-*-***-***-*-*-***-***-*************-*-*******-***-*-*-***-
-*-----*-*---*-*---*-*-*-*---------*-*---*-*-*-------*-------*-*---*---------*-*-*---*-----*-*---*-*-
-***-***-***-*-*****-*-*-*-*****-***-*-*****-*-*****-*****-***-***-*-*****-***-*-***-*-***-*-*****-*-
-*-*-*-----*-*-------*-*-*-*---*-*---*-----*-*-*---*-*-*-*---*---*-*-*---*-*---*---*---*-*-*-------*-
-*-***-***-*-*-*****-*-*-*-***-*-*-*-***-***-***-***-*-*-*****-*-*-*****-*-*-***-***-***-*******-***-
-*-----*-*-*-*-*-*-*-*-*-*---*-*-*-*-*-*---------*-----*-------*-*-----*-*-*---*-*---*-----------*-*-
-*****-*-***-***-*-***-*-*****-*-*-***-***-*******-*****-*******-***-***-*-*****-***-*****-*****-*-*-
-----*-*---------*-----*-------*-*-*-----*-*-------*-----*-----*---*-----*---------*-*-----*---*-*---
-***-***-*********-***-*******-***-*-***-*-***-*****-*****-*-***-*-*-***-*********-***-*****-*-*-***-
-*-*---*-*---------*---*-------*-----*-*-*---*-*---*-*-----*-*-*-*-*-*-*-------*-*-----*-----*-*---*-
-*-*-***-*****-*********-***-***-*****-*-***-*-***-*-*-*****-*-***-***-*********-*-***-*-*****-***-*-
-*-*-*-------*-----------*-*-*---*-----*-*---*-----*-*-----*-*-------*-----------*-*-*-*-----*---*-*-
-*-*-*-***-***-*********-*-*****-***-***-***********-*******-***-*****-***-*******-*-*-*-*******-*-*-
-*-*---*-*-*---*-------*-*---------*-*---*-----*-------------*-*-*-----*-*---*-------*-*-*-----*-*-*-
-*-*****-*-*********-*-*****-*******-*-***-***-*-***********-*-***-*****-***-*-*******-*-*-*****-*-*-
-*-------*-*-------*-*-------*-------*-----*-*---*---------*-------*-------*-*-----*-*-*-*-------*-*-
-*-*******-*-***-***-***-*****-*-***-*******-*****-*******-***-*****-*******-*******-*-*-***-*****-*-
-*-*---------*-*-*---*-*-*-----*-*-*---------------*---*-----*-*-----*---------------*-*-*-*-*-----*-
-*-*-*********-*-*****-*-***-*****-*******-*****-***-*-*******-*-***-*****-***-*****-*-*-*-*****-***-
-*-*-----*-----*-----------*-*-----*-----*---*-*-*---*---------*-*-------*-*-*-*-*-*-*-*-------*-*-*-
-*-*-***-*-***-*****-*******-***-***-***-*-***-*-*-*************-*-*******-*-***-*-*-*-*****-***-*-*-
-*-*-*-*-*-*-*-----*-*-----------*-----*-*-*-----*-----*---------*-*-------*-----*-*-*-----*---*---*-
-*-***-***-*-*****-*-***-*******-*****-***-*-***-*****-*****-*****-***-***-***-***-*-*****-***-*****-
-----------*-------*-*-*-*-----*-*---*---*-*-*-*-----*-----*-*-*-*---*-*-----*-*---------*---*-------
-***************-***-*-*-*-***-*-***-***-*-***-*-***-*****-*-*-*-*-***-***-***-*********-***-***-***-
-*-------------*-*---*-*-*-*---*---*---*-*-----*-*-*-----*-*---*-*-*---*-*-*---------*-*---*---*-*-*-
-*******-***-***-*-*-*-***-***-*-*****-*-*******-*-*****-*-*-***-*-*-*-*-***-*****-*-*-***-***-***-*-
-------*-*---*---*-*-*-------*-*-*-----*-*-----*-*-*-----*-*-*-----*-*-*-----*-*-*-*-*-------*-----*-
-***-***-***-*****-***********-*-*-*****-*-***-*-*-*******-*-*******-*-*-*****-*-***-*-*******-*****-
-*---*---*-*-------*-----------*-*-*-------*-*---*---------*---*-----*-*-------*---*-*-*-------*---*-
-***-*-*-*-*****-*****-***-*****-*-*-*******-***-*****-*******-*-*****-***-*****-***-***-*******-*-*-
-*-*-*-*-*-----*-*-----*-*-*-----*-*-*---------*-----*-----*-*-*-*-------*-*-------------*-------*-*-
-*-***-***-***-***-*-***-***-*****-*-*-***-*-*****-*-*-***-*-*-*-***-*****-*-***-*******-***-*-***-*-
-*-----*---*-------*-*-------*-----*-*-*-*-*-*---*-*-*-*-*---*-*-*-*-*-----*-*-*-*-----*---*-*-*-*-*-
-*-*****-*******-***-*-*****-***-*-*-***-***-***-***-*-*-*-***-*-*-***-*****-*-***-***-***-*-***-***-
-*-*-----*---*-*-*---*-*---*---*-*-*-*---------*---*-*-*-*-*---*-----*-----*-*-----*-*---*-*-*-------
-*-*****-***-*-***-***-***-***-***-***-*****-***-*-*-***-***-*-*****-*******-*-***-*-*****-*-***-***-
-*-----*---*-*-*---*---*-----*---*-----*---*-*---*-*---------*-----*-------*-*-*-*-*-------*---*-*---
-*****-***-*-*-*-***-***-***-***-*-***-*-*****-***-*-*************-*-*****-*-*-*-*****-*****-***-***-
-----*---*---*---*-------*-*---*-*-*-*-*---------*-*-----*---------*-*---*-*-*-------*-*-----*-----*-
-***-***-***-***-***-***-*-*****-*-*-*-*********-*-*****-***-*****-***-*-*-*-*-*****-***-***-*****-*-
-*-*---*---*---*---*-*-*-*-----*-*---*---------*-*-----*---*-*---*-----*-*---*-*---*-----*-------*-*-
-*-*****-*******-***-*-*-*-***-*-*************-*-*****-***-*-*-*-*******-***-***-***-*******-*****-*-
-*---------------*---*-*-*-*-*-*-----------*---*-*-*-----*-*-*-*-------*---*-*---*---*-----*-*-----*-
-***-*************-***-*-*-*-*-*-*******-***-***-*-*******-*-*-*******-*****-***-***-*-***-*-*-*****-
---*-----*---------*-*-*-*-*-*-*-*-*-----*---*---*-------*-*-*---*-------------*---*-*-*-*-*-*---*-*-
-*-*******-***-*****-*-*-***-*-***-*-***-*-*-***-*-*****-***-***-*******-***-***-*-*-*-*-***-***-*-*-
-*---------*-*-*-----*-*-----*---*---*-*-*-*---*---*---*-------*-----*-*-*---*---*-*-*-*-------*-*-*-
-*****-*****-*-*-***-*-*******-*-*-***-***-***-***-***-*********-*****-*-*********-*-*-*-*****-*-*-*-
-*---*---*---*-*-*-*-*---------*-*-*-------*-----*---*-----------*-----*-*---------*-*-*-*---*-*-*-*-
-***-***-*-***-***-*-***-***-***-*-*-*-*********-***-*****-***********-*-*-*********-*-*****-*-*-*-*-
-*-*---*-*-*-----------*-*-*-*-*-*-*-*-*-----*-----*-----*-----------*-*-*-*---------*-------*-*---*-
-*-***-***-***********-***-*-*-***-*-*-*-*-***-*********-*-***********-*-*-***-*****-*-*******-***-*-
-----*---------------*-----*-*-----*-*-*-*-*---*---*-----*-*-----------*-*---*-*---*---*-----*---*-*-
-*****-*****-*******-***-***-***-*-*-*-***-***-***-*-*****-*-*****-***-*-*-*-*****-***-*-***-*-*-***-
-*---------*-*-*-------*-*-----*-*-*-*---*---*---*-*-*-----*---*-*---*-*-*-*---------*-*-*-*-*-*---*-
-*-*******-***-*****-*****-***-***-*-*-***-***-*-*-*-*-*****-***-*****-*-*-*****-*****-*-*-*******-*-
-*-*-----*-------*-*-*-----*-----*-*-*-*---*-*-*-*---*-*-----*-----*---*-*-----*-*-----*-----*-----*-
-*-*****-*******-*-***-***-*******-*-***-***-***-*****-*-*****-*****-***-*******-*-*****-***-*-*****-
-*-----*-------*-*-----*-*-------*-*---*-*-------------*-*---*-*-----*-------*---*---*-*-*-*-*-*-----
-*-*******-*****-*-*-***-*******-*-***-*-***-***********-*-*-*-***-*-*******-*-***-***-*-*-*-*-***-*-
-*-*-------*-----*-*-*---------*-*---*-----*-*-------*---*-*-*---*-*-------*---*---*---*-*-*-----*-*-
-*****-*****-*******-*-***-*-***-***-*****-*****-*****-*****-*-*****-*-*****-***-*****-*-*-*-*****-*-
-*-----*-------------*-*-*-*-*-----*-----*-----*-*---------*-*-----*-*-*-----*-------*---*-*-*-----*-
-***-***-***-***-***-***-***-*-*****-***-*****-*-***-*****-*-*****-*-*-*-*****-*******-***-*-*******-
---*-*-*-*-*-*-*-*-*-------*-*---*-----*-----*-----*---*-*-------*-*-*-*---*---*-------*---*-------*-
-*-*-*-*-*-***-***-***-*****-***-*****-*****-*-***-***-*-*-*******-***-*****-*-*****-***-*-*******-*-
-*-*-*---*-----------*-*-------*-----*-----*-*-*-*---*-*-*-*-*-------*-------*-*---*-*---*-------*-*-
-***-***-***-*******-*-*-*****-*-***********-***-***-*-*-***-*-*****-*-*****-***-*-*-*-*****-*-***-*-
-*-----*---*-------*-*-*---*-*-*-------------------*-*-*-------*---*---*---*-*---*-*-*-*---*-*-*---*-
-*****-*************-*******-*-***********************-***********-*******-*******-*****-*****-****$-