16 16
#**----------------------------------------------
************-**************-**************-*****-
----**----**-------**-**----**----**----**-**----
-*****-********-**-**-**-********-**-***********-
-**-**-------**-**-**-**-**-**----------**-**-**-
-**-*****-*****-*****-*****-***********-**-**-**-
-**-------**-**-------**-**----**-**----**----**-
-*****-*****-**-********-*****-**-*****-*****-**-
-------------**-------------**-**-**-------------
-********-**-**-**************-**-*****-**-*****-
----**----**-**-------**----------**-**-**----**-
-***********-**************-********-**-********-
----**----**----**-**----------**-**----**-------
-*****-********-**-**-**-*****-**-***********-**-
-**-------**----**----**----**----**-**-**-**-**-
-**-**-**-***********************-**-**-**-*****-
----**-**-**----**-------**-------**----------**-
-********-*****-**-*****-**-*****-*****-**-*****-
-**----**----**-------**-------**-**----**-**-**-
-**-*****-**-**-*****-*****-**-**-**-********-**-
----**----**-**----**-**----**-**-------**-------
-**************************-*****-**************-
-**-------**----**-------**-**----------------**-
-**-***********-********-**-*****-**-*****-**-**-
-**----------**-**-**-**----**----**----**-**----
-**-**-**-**-**-**-**-********-*****-*****-*****-
-**-**-**-**-**-------**-**-------**----**-**----
-*****-**-*****-**-*****-********-********-*****-
----**-**-**-**-**----**-------------**----**-**-
-**-*****-**-*****-**-**-***********-********-**-
-**-**----**-------**-**-------**-**-------**----
-********-*****-*****************-**************
----------------------------------------------*$
