20 20
#**----------------------------------------------------------
******-***********-**-**-*****-***********************-**-**-
----**----**-**----**-**-**-**-------**----**----**----**-**-
-*****-*****-**-*****-*****-*****-*****-*****-*****-********-
-**----------**-**-**-**----**-**-**-**-**----**-**-------**-
-*****-*****-*****-**-**-**-**-*****-**-**-*****-***********-
-**----**-**-**----**----**-**-**-**-**-------**----**-------
-**-*****-**-*****-*****-**-**-**-**-**-**-*****-**-********-
-**----**-**----**-------**-------------**-**----**-------**-
-********-**-**-*****-**-*****-***********-********-*****-**-
-**-**-------**----**-**-**-------------**-------**----**-**-
-**-**-**-********-**-**************************-**-**-*****-
-**----**----**-**-**-------**-**-------**-**-------**-**----
-*****-*****-**-***********-**-********-**-********-*****-**-
-**-------**-**----**----------**----------------**----**-**-
-********-********-***********************-*****-**-**-**-**-
-**-------**-**-------**----------**----**-**-**-**-**-**-**-
-*****-**-**-********-***********-**-**-*****-**-**-********-
-**----**-**----**-------**----**----**-**-**-------**-------
-**************-*****-*****-********-**-**-**-**-**-**-*****-
-**-**-**----**-------**----**-------**-**-**-**-**-**----**-
-**-**-**-********-*****-**-**-********-**-*****-********-**-
-**-------------------**-**-**-**----------------------**-**-
-**-**************-********-**-**-**-********-**-*****-*****-
-**----**-**-**----------**----**-**-------**-**----**-**-**-
-********-**-********-**-**-***********-**-**-********-**-**-
-**-------------**----**-------------**-**-**-------**-**----
-*****-***********-**-********-**-**************-***********-
-**-**-------------**-**-**----**-**----------**-------**-**-
-**-***********-********-*****************-**-**-********-**-
-**-------**----**-**-------------------**-**----**-------**-
-**-*****-**-*****-********-**-********-*****-********-**-**-
-**-**-**-**-**----------**-**-**----**-------**----**-**-**-
-*****-**-*****-********-********-*****-***********-**-*****-
-------**----**-**-**-**----**-**-**----**----**----**----**-
-**-********-**-**-**-********-**-***********-**-**-**-*****-
-**----------**-------**-**----**----**-**----**-**----**-**-
-*****************-*****-**-*****-*****-**-*****-**-*****-**-
-**-------**----**----**----**----**-**----**-**-**----------
-*****-********-**-*****-*****-*****-**-*****-**************
----------------------------------------------------------*$
