47 47
#**-------------------------------------------------------------------------------------------------------------------------------------------
***-***********-**-**-**-**-***********-**-********-**-*****-**************-**-**-*****-*****-********-********-*****************-********-**-
-**-**----**----**-**-**-**-**----**----**-**-**----**-**----**-**-**----**-**-**----**-**----**----**-**-**-**-**-**----**-**-------**-**-**-
-*****-**-*****-***********-**-*****-**-**-**-**************-**-**-**-**-*****-**-*****-***********-**-**-**-*****-*****-**-*****-*****-*****-
----**-**-------**-------**-**-**-**-**-**----**-------------**-------**----**-**----**----**----------**----**----------------------**----**-
-**-*****-**-***********-*****-**-********************-**-********-**-*****-**-********-*****************-**************-**-**************-**-
-**-**----**-**-------**-**----**-**-------------**----**----**----**-**-**-**----**----**-------**-**-**----**----------**-**-**-**-**----**-
-**************-**-*****-*****-**-********-***********-********-**-*****-**-*****-*****-**-********-**-**-**************-*****-**-**-*****-**-
-**----**-------**-**-**----**-**-------**-**-**-**-**-------**-**----**----**-------**-------------------------**-------------**----------**-
-*****-**-***********-**-**-**-**-********-**-**-**-***********-*****-********-********-*****-*****-*****************************-*****-*****-
-------**-------**----**-**----**----**-------**-------------**-**-**-**----**----**-**-**----**-------**----------**----**-**-------**-**----
-*****-**-**-********-********-**-**-**-***********-**************-**-*****-********-**-********-**-*****-*****-**-*****-**-*****-*****-**-**-
-**-**----**-------**----**-**----**----**-**----------------**----**----------**-**----**-**----**----**-**----**-**-------**-**-**----**-**-
-**-**************-**-*****-*****-********-*****-********-**-**-**-*****-********-**-*****-***********-********-***********-**-*****-**-*****-
----**-**----**----------------**----------**-------**----**----**-**-------------------**-**-**-------------**-**-**----**----**-**-**-**-**-
-*****-**-***********************-*****-*****************-********-*****-***********-*****-**-*****-**-*****-**-**-*****-**-*****-*****-**-**-
-**----------------------**----**-**-**-**----------------------**-**-------**----------**-------**-**-**----------**-**----**-**----------**-
-**************-**-*****-*****-**-**-**-**-**-********-********-**-**-*****-*****-**-*****-**-*****-**************-**-**-**-**-***********-**-
----------**----**----**-**-**-**----**----**-------**----**-**-**-**-**-------**-**----**-**----**-------**-------**----**----**-------**-**-
-**-*****-*****-*****-*****-**-**-*****-**************-*****-***********-*****-*****-*****-********-********-********-**-*****-*****-*****-**-
-**----**----**-**-------**-**----**-**-**-------**----**-**----**-**----**----**-**----**-**-------**-**-------**----**----**-**-------**----
-*****-*****-*****-*****-**-********-**-**-**-**-********-*****-**-**-**-**-**-**-********-***********-**-*****-**-********-***********-*****-
-**-**-**----------**----**----------------**-**-------**-**-**----**-**-**-**-**----------**-------**----**----**-**-**-------**-------**-**-
-**-*****-*****-**-********-**-*****-***********-********-**-**-**-**-**-*****-**-*****-*****-***********-***********-**-**-********-**-**-**-
-**-**-**----**-**-**----**-**----**----**-------**----------**-**----**-**----------**-**-------**-**----**----**-------**-**----**-**-**-**-
-**-**-*****-********-**-********-**-**-*****-**************-**************-*****-***********-*****-**-**-**-*****-*****-*****-********-**-**-
----**----**-------**-**-**-------**-**-**-------**----------------**----------**-**-------------**----**-------**----**----**-------**-------
-*****-**-**-**-*****-********-**-**-********-***********-**-**-********-*****************-*****-**-***********-*****-**-***********-*****-**-
-**----**----**----**-**-**-**-**-**----**----**----**----**-**----------**----------**----**-**----**----**-------**-**-------**----**-**-**-
-*****-***********-**-**-**-***********-********-********-**-**-**-*****-*****-**-**-**-*****-**-*****-**-*****-***********-********-**-*****-
-**-**-**----------**-------------------**-**-------------**-**-**-**----**-**-**-**-**-**-------**-**-**----**-**-------------**-**----------
-**-***********-**-**-*****-*****-*****-**-**-**-**************************-*****-*****-**-********-*****-***********-*****-**-**-**-**-*****-
-**-------**-**-**-**-**-------**-**----**-**-**-**----**----------**-**-**-------------**-**-**-**-**-**-**-**----**----**-**----**-**-**----
-*****-**-**-***********-***********-**-**-**-**-*****-**-*****-**-**-**-**-*****-***********-**-**-**-**-**-**-**-*****-**-*****-**-**-*****-
-------**-------**----**-**----**----**-**----**-------**----**-**-**----**----**----------**-**----**-**-------**----**-**-**----**-**----**-
-**-**-*****-*****-**-**-*****-*****-***********-**-*****-**************-**-**-**-********-**-*****-**-**-********-*****-**-*****-*****-**-**-
-**-**----**----**-**----------**-**----**----**-**----------**----**-**----**-**-**-**-------------------------**-**-**-**----**-------**-**-
-**************-**************-**-*****-**-***********-********-**-**-**-********-**-********-**-********-***********-*****************-**-**-
-**-------**----**-------**----**-------------------------**----**----**-------**----**-**-**-**-------**-**-------**-**----------------**-**-
-**-*****************-**-***********-*****-***********-**-*****-*****-**-**-**-********-**-*****-***********-**-*****-**-**-**-*****-********-
-**-------**----------**----**----**-**-**----**-------**-------**----**-**-**----**----------**-**----**----**-**-**----**-**-**----------**-
-**-*****************-***********-*****-********-*****-*****-*****-********-***********-**-*****-*****-**-**-*****-**-**-**-*****-*****-*****-
-**-------**----------**-**-------**----**-**-------**-**-**-**-**-**----**-------**----**-------------**-**-**----**-**-**----**----**-**----
-**-**************-*****-********-*****-**-**-***********-**-**-*****-********-**-*****************-**-*****-*****-**-***********-**-********-
-**----**-------------**----**-**-**-**-**----**----------**-**----**-**-**-**-**-**----------**-**-**-**----------------**-------**-------**-
-*****-**-*****************-**-**-**-**-*****-**-**-********-**-*****-**-**-*****-*****-********-**-**-*****-*****-**-**-*****-**-**-********-
-------------**-**----**-------------**----------**-**-------------**-**----**-**-**----**-**-**-**-**-**----**-**-**-**-**-**-**-**-**----**-
-*****-********-**-********-**-**-**-**-*****-********-**-***********-**-*****-*****-*****-**-**-**-********-**-***********-**-**-********-**-
-**-------**----**----------**-**-**-**-**-**----**-**-**----------**----------**----**-**----**----**-**-**----------------**-**----**-------
-*****-*****-*****-*****-***********-*****-**-**-**-**-********-***********-**-**-*****-*****-*****-**-**-********************-*****-********-
----**-**----**----**-**-**-------**----**----**-**-**-**-**-**-------------**----**-**-**-------------------**-**----**-**----**-**-**-------
-********-*****-*****-*****-**-********-*****-*****-**-**-**-**-*****-**-*****-*****-**-********-**************-**-**-**-**-*****-********-**-
-**----------**----**-------**-------**-**-------**-**-**-**-------**-**-**-------**----**-------**----------**----**----------**----**----**-
-**-**-**-**-**-**************-*****-**-********-**-**-**-**-*****-*****-**-***********-*****-********-********-*****-**-***********-**-*****-
-**-**-**-**-------**-------------**-**----**-**----**-**----**----**-**-**----**----**-**-**-------**-**-**-------**-**----**-**----**-**----
-*****-***********************-**************-********************-**-***********-*****-**-*****-*****-**-***********-********-**-**-********-
-**-**----**----**-**----**-------------**-------**----**-**----**-**-**----------**----------------------**----**----**-------**-**-**-------
-**-**-**-*****-**-*****-********-********-**-**-**-*****-**-********-*****-********************-**************-**-*****-**-*****-*****-*****-
-------**----**----**----**-**----**-------**-**-**----**-------**-------**----**-**-**-**----**-**-**-**-------**-**----**-------**----**----
-***********-**-*****-*****-**-*****-**-**-********-*****-**-**-********-*****-**-**-**-*****-**-**-**-**-***********-**-*****-***********-**-
-**----**-**----**----**-**----------**-**-**----**----**-**-**-------**----**-------------**----------**-------**-**-**-**-**----------**-**-
-*****-**-**-********-**-*****-*****-*****-*****-**-**-**-********-*****-*****************-*****-********-**-**-**-********-**-*****-**-*****-
-**-------**----**----**-**-**----**-**----**-------**-------**-------------**----------**----------------**-**-**-**----------**-**-**----**-
-**-*****************-**-**-**-*****-**-*****-***********-********-**-*****-**-*****-***********-**-**************-**-***********-**-********-
-------------------**----------**-**-**----**----------**-------**-**----**-**-**-**-**-------**-**-**----------**----------**----**-------**-
-*****************-*****-********-*****-**-*****-**************-********-********-**-********-**-********-**************-**-*****-**-**-*****-
----**-**----------**----------**-**-**-**----------**----------**-------**-**----**-**----------**----------**-**-**----**-**----**-**----**-
-*****-**-**-*****-**-**-**-*****-**-*****-**-**-********-**-*****-********-**-**-**-**-********-*****-********-**-**-********-**-**-********-
----**----**----**-**-**-**-**-------**----**-**-**-------**-**-------------**-**-------------**-------**-------**----**-------**----**----**-
-********-*****-********-*****-**-**-***********-**************-*****-***********-**-**************-**-*****-********-*****-**-*****-*****-**-
-**----**-**-**----------------**-**----------**-**-**----------**----**----**-**-**----**-**----**-**-**-------**-**----**-**-**-**-**-**----
-**-**-*****-**-**-**-*****************-**-**-*****-********************-*****-***********-*****-*****-**-**-*****-*****-********-*****-*****-
-**-**-**-------**-**----**-------**----**-**----**-------**-------**----------**-------------------**----**-**-**----------------------**-**-
-*****-*****-**-**-**-***********-**-*****-**-**-**-**-**-**-**-**-*****-********-**-*****-*****-*****-********-**-********-**-***********-**-
-------**-**-**-**-**-------**----**-**----**-**-**-**-**----**-**----------**----**-**-------**----**----**-**----**-**----**-------------**-
-**-*****-**-**-**-*****-********-**-*****-**-**-**-***********-********-********-*****-***********-**-*****-**-*****-********-*****-********-
-**-**-------**-**-**-------**-**-------**-**-**-**----**-**----------**----**-------**----**-**-**-**-**----**-------**-------**-**-**-**----
-*****************-*****-*****-********-**************-**-*****-***********-********-********-**-**-********-*****-********-*****-*****-**-**-
-**-------**-**----**-------**-------**-**-**-**-**-**-**-**-------------**-**-------**-------------**-------**-**-**----**-**-------**----**-
-*****-*****-**-***********-*****-**-*****-**-**-**-*****-*****-**************************-*****-**-**-*****-**-********-**-**-*****-********-
----**-------**-**-------**-**----**-**----**-**----------**-------------**-------**-------**-**-**-**----**-------**----**----**-------------
-*****-*****-********-**************-*****-**-**-********-********-**************-**-**-*****-*****-**-*****************-**-**-**-***********-
-**----**-------**-------**-**-------**-**----**-------**-**-**-------------------**-**----**-**-------**----**----**----**-**-**-**-------**-
-**-*****-********-**-**-**-**-********-**-**-*****-********-********-*****-***********-*****-*****-**-**-*****-*****-***********-**-*****-**-
-**-**-**----------**-**-**-**----**----**-**-------**----**----------**-------**----------**----**-**----**----**-**-------**----------**-**-
-*****-*****-**-***********-*****-*****-**-**-**-*****-**-**-**-**-*****-**-*****-**-********-***********-**-*****-*****-**-**-**-**-********-
-------------**----**-------------------**-**-**-**----**-**-**-**-**----**-**----**----------**----**-------------------**-**-**-**-**-**----
-********-**-*****-*****-**-********************-**-**-********-**-*****************-**************-*****-*****-**************-********-*****-
----**----**-**----**----**-**----**-**----**----**-**-**----**-**----------**-**-**----------**-**----**----**-**----------**----**-------**-
-*****-**************-**-**-*****-**-**-*****-*****-********-*****-*****-*****-**-**-*****-**-**-**-********-**-**-********-***********-*****-
-**-------------**-**-**-**-------------------**-**-**----**----**-**-------------**-**----**----------**-**-**----**----**-**-------**-**----
-********-********-********-*****-**************-**-**-**-*****-*****-*****-*****-**-********-*****-*****-*****-**-**-********-**-**-**-**-**-
----**-**----**----**----**-**----**----------**----**-**-------**----**----**-------**-**-**----**-**----**----**-**----**-**-**-**-**-**-**-
-*****-********-********-**-**************-********-**-***********************-********-**-***********-**************-*****-**-********-*****
-------------------------------------------------------------------------------------------------------------------------------------------*$
