17 12
*-**-****-**
*-**-****-**
*-**-****-**
*-**-****-**
*-**-****-**
*-**-****-**
*-**-****-**
*-**-*******
*-**-****-**
*-**----*-**
****-****-**
*--*--*---*-
*-**-****-**
*-*--*----*-
*-*--****-*$
*-*--*------
#***********