64 97
#**----------------------------------------------------------------------------------------------
***-*****-**************-**-*****-**************-********-**-**-*****-********-********-**-*****-
-**----**-**-------**-**-**-**-**-**-------**-**----**----**-**-**-**----**----**-**----**-**----
-**-**-***********-**-**-*****-*****-********-**-*****-********-**-**************-**************-
-**-**-**-**----**-------------**----**-**-**-**----**-**-**-------**----------**-------------**-
-**-**-**-**-**-**-*****-*****-**-**-**-**-**-**-**-*****-*****-*****-********-**************-**-
-**-**-**----**-------**----**-**-**-------**----**-**----**-------**-**-------**-------------**-
-***********-*****************-**-********-*****-**-**-***********-***********-**-*****-********-
-**----**-**-**-**----**-**-**-**-**-------------**----**----------**-**----**----**-**----**----
-**-*****-**-**-*****-**-**-*****-**************-**-*****************-**-********-**-**-********-
----------**-**----------**-**-------------**----**-**----**----**-------**----------**----------
-*****-**-********-*****-**-*****************-**-********-*****-*****-*****-**-**-********-*****-
----**-**-**----**----**-------**-**-------**-**-------------------**-**----**-**-**----**----**-
-********-**-********-*****-*****-********-********-**-**************-********-*****-***********-
-------**-**-**-------**----------**----------**----**-------**-**-------**-**-**-------------**-
-**-********-********-**-**-********-********-********-*****-**-**-*****-**-********-********-**-
-**----**-**----**-**-**-**-**----**-**-------**----**----**----**-**-------**----**-------**-**-
-*****-**-*****-**-**-***********-********-*****-**************-***********-*****-**-**-********-
----**-**-**----**----------**-------**-**-**-**-------------**-**----**-**----------**-**----**-
-**-*****-*****-*****-********-**-*****-**-**-**-*****-**-*****-*****-**-*****-********-**-*****-
-**----**----------------**----**----**----**-**-**-**-**-**----**----------------**-------------
-**-**************-**************-*****-*****-**-**-*****-********************-**-*****-**-*****-
-**-**-------------**-**----**----------**-------------**-**----**-------**-**-**-**----**-**----
-*****-*****-*****-**-**-**************-**-**-**-**-**-********-**-********-**-**-**-**-**-*****-
-**-**-**-**----**----**----**-------**----**-**-**-**-**----**-**-------**-**-**-**-**-**----**-
-**-**-**-**-**-*****-**-**-********-*****-**************-*****-********-**-*****-********-*****-
----------**-**-**----**-**----**-**-**----------------**----**-**-------**-**-**----**----**-**-
-********-********-**-********-**-**-*****-**-********-*****-**-**-**-*****-**-**-**-********-**-
-**-------------**-**-------**----**-------**-**-**-**----**-------**----**----**-**-------**----
-**-**-**-********-**-********-***********-*****-**-**-**-**-*****-********-**************-*****-
-**-**-**-**-**----**----**----------**-------------**-**-------**----------**----------------**-
-*****-*****-**-***********-**************-**-**-*****-********-**-**************-**************-
-**-**-------**-**-------------------**----**-**-**----**----**-**-**----**-**-------**-**-**----
-**-**-**-*****************-*****************************-**-**-**-**-**-**-*****-*****-**-**-**-
-**----**-**----------**----------**-**-**-------**-------**-**-**----**----**-------------**-**-
-*****-********-***********-**-**-**-**-********-**-**-***********-*****************-**-********-
-**-**-------**----**-------**-**----------**-------**----**-**----**-**----------**-**-**-**----
-**-***********-***********************-**-**-********-*****-*****-**-*****-*****-**-*****-*****-
-**-**-**-------**-**-**-**----**-------**----**----------**----**----------**-------**-**----**-
-**-**-*****-*****-**-**-*****-**-*****-**-**-*****-********-********-***********-*****-**-*****-
-**----------**----------**----**----**-**-**-**----**----------------------**-**----**----------
-**-**-**-**-**-**-**-*****-*****-**-**************-*****-**-*****-*****-*****-***********-*****-
----**-**-**-**-**-**-------**----**-------**-**----------**-**-------**----**-**-------**----**-
-***********-********-*****-*****-**-********-**-*****-*****-***********-**-**-*****-***********-
-**----**----**----------**----**-**-**----**-------**-**-------**-**----**-**-**-**-------**----
-*****-***********************-**-**-*****-*****-*****-********-**-***********-**-*****-********-
----**-------------**-**-**----**-**-------**-------**-**----**-**----**-**-------**----**-------
-*****-**************-**-**-*****-**************-***********-********-**-**-**-**-*****-**-*****-
----**----**-------------**----**----**-**----------**----**----**-**-**----**-**-**-------**-**-
-**-**-***********-*****-*****-**-*****-*****-**-**-**-*****-*****-**-*****-***********-*****-**-
-**----------**-**----**-**----**-------**----**-**----**-**-**-**----**-**-------**-**-------**-
-**-**-********-**-***********-*****-**************-**-**-**-**-**-**-**-*****-*****-********-**-
-**-**-**-**-------**----------**-------**-**-------**-**-------**-**----**----**-**----------**-
-********-********-********-**-**-**-*****-**-**-********-**-********-**-**-**-**-**-*****-*****-
----**-**----------**----**-**----**-**-------**-------**-**-**----**-**-**-**----**----**----**-
-*****-*****-*****-**-**************-*****-*****-**-*****-********-**-********-********-**-*****-
-**-**-**-------**-**-------**-**-**-**----**----**-**-**-------------------**-**----**-**-**-**-
-**-**-**-*****-*****-*****-**-**-*****-**-********-**-********-********-*****-*****-**-*****-**-
-------**----**-**-**----**-**-**----**-**-**-**-**-**----------**-**-------**-**-**----**-**----
-**-*****-********-**-**-*****-*****-********-**-********-*****-**-*****-*****-**-********-*****-
-**----------**-------**-**-**-**-**----**-------**-------**-------**----**-**----**----**----**-
-*****************-**-*****-**-**-**-*****-*****-**************-*****-**-**-**-**-*****-**-**-**-
-**----**-------**-**-------**-**----------**-**----------**----**----**-**----**-**-------**-**-
-*****-********-*****-********-********-*****-********************-********-********-***********-
----------------------------------------------------------------------------------------------**$