40 40
#**----------------------------------------------------------------------------------------------------------------------
*********-*****-*****-********-*****-*****-*****-**-**************-**************-**-**************-*****-**************-
----**-**-**-------**-**-**-**-**----**----**-**-**-**----**-------**-------**----**----**----**----**----------**-------
-*****-***********-*****-**-**-*****-*****-**-**-********-********-**-********-**-********-***********-*****************-
-**----**-------**-**-**-**----**----**-------**-------**----------**----**-**-**-------**----**----**----**-------**-**-
-**-*****-**-**-*****-**-********-**************-*****-**-*****-**-**-*****-*****-********-*****-**-***********-**-**-**-
----**----**-**-**-------**-**-**-------------**-**----**----**-**-**-**-**----**-**-**----**----**----**-**-**-**-**----
-**-*****-********-*****-**-**-**-********************-***********-**-**-**-********-*****-*****-********-**-**-**-*****-
-**-**----**-**-**-**-------**-------**-**-**----**-------**----**----**-------**-**----**-------------**----**-**-------
-**-*****-**-**-*****-**-**-***********-**-**-**-**-***********-**-********-*****-**-*****-********-**-**-**-********-**-
-**-**-------**-------**-**-**----------------**-**----**----**----------**----**----------**-------**----**----**----**-
-*****-*****-**-*****-***********-*****-**-*****-*****-**-*****-*****-**-*****-*****-**************-*****-*****-********-
-**----**-**----**----**-------**-**----**----**-**-------**-**-**-**-**----------**-**----**-**----**-**-**-**-**-------
-*****-**-*****-**************-*****-***********-**-********-*****-**-********-**-*****-*****-********-**-**-********-**-
----**----**-**----**----**----**----**-**-------**-------------**----------**-**-**----------------------**----------**-
-********-**-*****-**-*****-**-********-********-**-**-*****-********-**-***********-*****-**-**-**************-**-*****-
-**-**-**-**-------**----**-**-------**----**-**-**-**-**-**-**----**-**-**-------**-**-**-**-**----**-------**-**----**-
-**-**-**-********-**-*****-********-**-**-**-**-**-*****-**-*****-*****-**-*****-**-**-*****-********-*****-**-********-
-------**-**----**----**-**-**----**-**-**----**-------**----**-**----**-------**-**----**-------**-------**-------**-**-
-*****-**-*****-********-*****-*****-**-*****-********-**-*****-**-***********-*****-***********-**-**-*****-********-**-
----**-**-**-------------**-**-**-**----**-------**----**-**-**-**----------------**-**----**-------**-**----**-------**-
-********-**-*****-********-**-**-********-**-*****-**-*****-**-**-***********-*****-*****-**-**************-********-**-
-**-**----**-**----------------**----**----**-------**----**----**-**----------**----**-------**-**----**----**----------
-**-**-*****-*****-********-*****-*****-**-*****************-**-********-*****-**-**-*****-*****-*****-**************-**-
-------**----**-**----**-**----------**-**-------**----**----**----**----**----**-**-**-------**----**-**----**----**-**-
-***********-**-********-***********-********-**-**-**-*****-**-**-*****-*****************-**-**-**-**-*****-**-********-
----------**-**----------------**-**----**-**-**----**-**-**-**-**----**-**-------**-------**----**----------**-**----**-
-***********-**-***********-*****-**-*****-***********-**-*****-***********-**-*****************-*****-********-*****-**-
-**----**----------**-------**----**----**----**----**-**-**-**-**----**----**-**-------**-**-**-**----**-------**-------
-*****-**************-**-*****-********-**-********-*****-**-**-**-**-*****-***********-**-**-********-*****-**-*****-**-
-**-**-------**----**-**-------**----**-**----**-------**----------**----**----**-------**----------**-**----**-------**-
-**-********-**-**-*****-*****-**-*****-**-********-*****-*****-**-*****-**-********-*****-*****-***********-*****-*****-
-**----------**-**-**-**-**----**-------**-**----**-------**----**-**----**----**-**-------**----------**----**-**-**----
-**-********-*****-**-**************-*****-*****-*****-***********-*****-**-**-**-**-********-**-**************-*****-**-
----------**----**----**-------------------**-------**----**----**-**----**-**-------**-------**-**-**-**-**----**-**-**-
-********-***********-***********-**-*****-********-**-**-**-**-*****-**************-**-*****-**-**-**-**-*****-**-*****-
-------**-**-**-------------**-**-**-**-**----**-------**----**----**-**-------------**----**-**----**----------**-------
-*****-*****-********-********-**-*****-*****-*****-*****-*****-**-*****-**************************-*****-*****-**-*****-
----**-**-------------------**----------**-------------**-**-**-**-**----**----**----**-**-**-**----**-**-**-------**----
-********-*****-**-********-**-***********-**-*****-*****-**-**-***********-*****-**-**-**-**-**-*****-***********-**-**-
-**----------**-**-------**----**-------**-**-**-**----**----**-**-**-------**----**-**-**----**----**-**-**-**----**-**-
-**-*****-**-**-**-*****-*****-**-***********-**-*****-***********-**-*****-**-**-**-**-**-**-**-**-**-**-**-**-**-*****-
-**----**-**-**-**-**----**-------**-------------**-**-**-**-**----**-**-**-**-**-**-**----**-**-**-**----**----**----**-
-**************-*****-*****************-***********-*****-**-*****-**-**-*****-**-**-********-*****-**-**-**-********-**-
-**-------------**-------**-------**-**----------**----**-**-**-**-------**----**-**-**-------**-**-**-**-**-**-**----**-
-*****-*****-********-********-*****-*****-*****-**-*****-**-**-**-**************-**-**-*****-**-**-**-********-*****-**-
-**-------**-**-**----**----------**----**----**-**----**-------**-------**-**-**-**----**----**-------**----**-------**-
-********-*****-*****-*****-*****-*****-*****-*****-*****-**-********-*****-**-**-***********-*****-********-*****-*****-
-**-------**-------------**----**----**-**-**----**-**----**----------**----------**-**-------**-**-**----**-**----**----
-*****-**-**************-*****-********-**-*****-**-********-*****-********-**-*****-*****-**-**-**-**-**-**-*****-*****-
-**----**-**----------------**----------------**-**-**----**-**----**-**-**-**----**-**----**----------**-**-**----**----
-**-**-*****-***********-***********-********-*****-*****-**-*****-**-**-**-*****-**-*****-**-***********-**-*****-**-**-
----**-**-------------**-**-**----------**----------**-**-**----**-**----**-**----------**-**----------**-**-------**-**-
-*****-**-*****-*****-*****-**-********-*****-**-*****-**-**-*****-**-**-*****-**************-**-**-********-*****-*****-
----**-**-**-**-**-**-**-**----------**-**----**----**-**-------**-**-**----**-**----------**-**-**-**----**----**----**-
-***********-*****-**-**-*****-***********-***********-********-**-**-*****-**-**-*****-**-***********-**-********-*****-
-**----------**-**-**-**-------**----**-**-**-------------------**-**-**-**----------**-**----------**-**-**----**----**-
-***********-**-**-*****-**-********-**-*****-********-***********-*****-**-**-**-**-**-***********-*****-**-********-**-
-------------------------**----------**-------**-------------**----**-------**-**-**-**----------**-**-------------**-**-
-**-**-*****-**-***********-*****-*****-*****-*****-*****-**-*****-********-***********************-*****-*****-********-
-**-**----**-**----------**-**-------**----**-**----**-**-**-**-**-------------------------------**-------**-------**----
-**-**-********************-********-**-*****-********-*****-**-**************-**************-**-*****-********-**-**-**-
-**-**-**-------------------**----**-**-**----**-------**-**----**----**----**----**-**-------**-**-**-**----**-**-**-**-
-**-**-*****-**-*****-********-**************-*****-*****-*****-*****-**-**-**-*****-**-********-**-********-*****-**-**-
-**-**-**-**-**-**----**-------**-**----**----**-------**----------**-**-**----**----**-------**----**-**----**-**-**-**-
-********-**-**************-*****-**-**-*****-*****-**-**-*****-**-**-********-*****-*****-*****-**-**-**-*****-*****-**-
----**-------**-**----**-------**----**----**-**-**-**-------**-**-**-------------------**----**-**----------**-**-**-**-
-*****-*****-**-**-*****-********-**-**-********-**************-*****-**************************-*****-*****-**-**-*****-
-**-**----**-------**-**-------**-**-**-**-**-**-------**----------**-------------**----**-**----**-**-**-------**----**-
-**-*****-********-**-*****-**-**-********-**-**-***********-**-**************-********-**-********-**-*****-********-**-
-**-------**----------**----**-**----**-------**-**----**----**----**-------**----------**-------**-**----**-**-**----**-
-**-***********-**-**-**-********-**-**-**-*****-**-***********-*****-********-***********-********-*****-*****-*****-**-
-**----**----**-**-**----**-**-**-**-**-**-------**-**----------**-**-**-------**-**-**-**-**-------------**-**-**----**-
-*****-*****-********-*****-**-*****-*****-********-***********-**-**-*****-*****-**-**-**-*****-***********-**-**-*****-
-**----------**----**----**-------**-**-**-**-**----**-------**-**-**-**----**-**-**----**-**----**-**-------------------
-**-**************-*****-*****-*****-**-**-**-**-*****-**-********-**-*****-**-**-*****-**-**-**-**-********-***********-
-**----**-------------**-**-**----------------**----**-**-**----**-------------**----------**-**-**----**-------**-------
-********-*****-***********-**-*****-**-**-********-**-********-**-*****-**-**-**-*****-*****-********-***********-**-**-
-**----**-**----**----**----------**-**-**----**-**----------------**-**-**-**-**-**----**-**----**-**-**-**----**-**-**-
-**-********-********-**************-***********-********************-*****-*****-********-********-**-**-**-***********
----------------------------------------------------------------------------------------------------------------------*$
