89 133
#**----------------------------------------------------------------------------------------------------------------------------------
***-**-********-*****-*****-***********-***********************-***********-***********-*****-*****************-********-***********-
-**-**-**-------**-**-**----**-**-**----------**-**----**-**-**-**----**----**-**----------**-**----**-**-**-**-**-**-------**-**-**-
-********-**-*****-**-*****-**-**-********-*****-*****-**-**-*****-*****-**-**-********-********-**-**-**-**-**-**-**-*****-**-**-**-
----**-**-**----**----**-**----------**-------**-**-**----**----**-------**-**-**----**----**----**----------**-**-------**----**----
-*****-**************-**-***********************-**-*****-*****-*****-********-*****-**-********-*****-**-**************-*****-*****-
----**----------**----------**----**----**-------**-------**----------**-**----**----**-**----------**-**-**-**----------**-**-**-**-
-*****-**-**-********-**-**-**-**-**-********-*****-**-***********-*****-*****-**-*****-********-*****-**-**-********-**-**-**-**-**-
----**-**-**-**-**-**-**-**-**-**----**-------**----**----**-**----**-------------**-**-**-**----**----**----------**-**----**----**-
-**-**-**-*****-**-**-*****-*****-***********-***********-**-*****-***********-*****-**-**-**-**************-**-*****************-**-
-**----**-------**----**-------------------**----**-**----**-**-------**----**----**----------**----**-**----**-**----**----**----**-
-********-**-*****-********-**-*****-**-**-**-*****-*****-**-**-**-*****-*****-********-*****-**-*****-**-********-*****-***********-
-**----**-**-**-**-**-------**-**----**-**-**----**----**-------**-------------**-**-**-**-------**-**-**----**-------------------**-
-**-*****-*****-********************-*****-**-*****-*****************-***********-**-*****-**-**-**-**-*****-***********-***********-
----**-**-**----**----------**----**-**-**-------**-------**-**----**-------**----------**-**-**-**----**----**----------**-**----**-
-*****-*****-**-**-**-***********-*****-**-**-********-*****-**-*****-**-***********-**************-***********-*****-*****-*****-**-
-------**-**-**-**-**-**----**-------**----**-**-**----**-**----**-**-**-------------**-**-**-**-**----**----------**-------**----**-
-**-*****-*****-**-********-********-*****-*****-*****-**-**-**-**-**-********-*****-**-**-**-**-**-**-**-**-*****-**-*****-**-*****-
-**-**-**-**-**-**-**----**----**-**-**----------------------**----**-------**-**----**-------**----**-**-**-**----**-**----**-------
-*****-**-**-**-**-*****-*****-**-**-***********-********-********-********-********-**-**-***********-**-*****-**-***********-*****-
-------**----**----**----------------**----------------**-**----**-**----------**-**----**----------------**----**-------**----**----
-**-**-*****-**-*****-********-********-*****************-*****-**-*****-*****-**-**-*****-**-*****-*****-***********-**-**-********-
-**-**----------**----**-**----------**-**-**----**-------------**-**-------**-**-------**-**-**-**----**-**----------**-**----**-**-
-**-********-***********-**-**-********-**-*****-**-**-********-*****************-*****-*****-**-**-**-**-**-**************-*****-**-
-**-**-**----**-**----**-**-**-------**----**----**-**-**----------------------**----**----**-**----**-**-**-**----**-**----**-------
-**-**-********-**-*****-*****-**-*****-*****-*****-*****-**-********-********-**-**-********-*****-**-*****-**-*****-**-*****-*****-
-**-**----------**----**-------**-------**----**-------**-**----**----------**-**-**-**-------**----**----**-**-**-**-**----**-**----
-***********-**-**-********-********-**-**-**-**-**-**-********-********-**************-*****-*****-********-**-**-**-*****-*****-**-
-------------**----------**----**----**----**-**-**-**-**-------**-------**----------------**----**-------**-**----------**----**-**-
-**-**************-***********-********-***********-**-*****-**-***********************-***********-***********-*****-********-*****-
-**----**-------**-**-**-**----**----------**----**-**----**-**-**-**----------------**-------**-**-**----**-------**----**-------**-
-***********-*****-**-**-********-********-**-**-***********-*****-*****-********-**-*****-*****-**-**-********-*****-*****-*****-**-
-**-------**----------**-------**-**----------**-**-------**-**----**----------**-**-**----**-**-------------------**-**----**-**-**-
-**-********-*****-**-**-**-*****-**-********-********-***********-*****-*****-**-*****-**-**-********************-**-*****-**-*****-
-------**-------**-**-**-**-**----**-------**-------------**-------**-**-**----**----**-**----**----------**-------**-**-**-------**-
-*****-********-**-********-**-********-********-********-*****-*****-**-*****************-*****-********-********-*****-**-*****-**-
-**----**-------**----**-**-------**----------**-**-**----**-**-**-------**----**----------**----------**----**-**-**----**-**----**-
-**-**-********-********-**-*****-**-*****-**-*****-*****-**-**-*****-*****-***********-********-**************-*****-**-**-********-
-**-**-------**----**----**----**-**-**----**-**-------**-**-**-**-------------------**----**----**----**-**-**----**-**-**-**----**-
-**************-*****-********-*****************-********-**-**-**-**-**-**-*****-***********-**-*****-**-**-**-**-**-*****-**-**-**-
----------**-------**----------**----**-**-------**-**-**-**----**-**-**-**----**----**-------**----**-**-------**----**-------**-**-
-********-***********-*****-*****-*****-********-**-**-*****-********-***********-*****-***********-**-********-*****-**-*****-*****-
-------**-------**-------**----**-**----**----**----**----------**-------**----**-**-**-**-------**----**-**-**-**----**----**----**-
-*****-**-*****-**-***********-**-**-**-**-**-**-**-********-*****-*****-**-********-**-********-********-**-*****-********-********-
----**-**-**----**-**----**-------**-**-**-**----**-**----**-------**----**-**-------------**----**-**----**----------------**-**-**-
-********************-*****-********-**-**-***********-*****-*****-**-*****-**-*****-***********-**-**-*****-**-**************-**-**-
----------**-------**----**-------**-**-------------**-**----**-**-**----------**-**----------**----------**-**----**-**----------**-
-**-**-********-*****-***********-*****-***********-**-********-**-*****-********-********-**-*****-*****-***********-*****-*****-**-
-**-**----------**----**----**-**-**-------**----**----------**----**-**-**----------**-**-**----**-**----**-**----------**----**-**-
-*****************-*****-**-**-**-**-***********-***********-*****-**-***********-*****-**-*****-**-*****-**-**-**-***********-**-**-
-------**----**-**-**----**-**----**-**----------**-------------------**-**-**-**----**----**-------**----------**-**-------**-**-**-
-**-********-**-**-*****-***********-*****-*****-**-********-**-*****-**-**-**-*****-**-**-*****-*****-*****-*****-********-**-*****-
-**-**----------------**-**-------**----------**-**-**-**-**-**----**-**----------------**-**----**----**----**----**----**----**-**-
-********-********-*****-**-**-**-*****-**************-**-*****-**-***********-***********-***********-**-*****-********-**-*****-**-
-**-------**-------------**-**-**-------------**-**-------**-**-**-**-**----**-**-**-------**-**-------**-**----**-**-**----**-------
-*****-***********-**-***********-**-*****-**-**-**-**-**-**-**-*****-*****-*****-**-********-********-*****-*****-**-*****-********-
-**-------**-**----**-------------**-**-**-**----**-**-**----------**-**-------**----**----------**----**-**-**-------------------**-
-*****-*****-**-**-**-**-***********-**-**-**************-*****-**-**-**-**-*****-**-**-**-**-**-********-********-**************-**-
-**-**-**-------**-**-**----**----**-**-**-**-**-**-**----**----**-------**----**-**-**-**-**-**-------**----**-**-**----**-**-------
-**-*****************************-*****-**-**-**-**-*****-**-**-*****-**-**-********-**-**-********-**-*****-**-**-*****-**-********-
-**-**-**-**-------------**----------**-------------**-**-**-**-**----**-**-**----------**-**-**----**-**-**-**-**-**-------**-**----
-**-**-**-*****-**-**-**-**-********************-*****-********-**************-*****-**-*****-**-**-**-**-**-**-***********-**-*****-
----------**----**-**-**----**----------**----**-**-------------**----**-**-------**-**-**-------**-**----**----**----**-------------
-***********-*****-*****-*****-*****-*****-********-********-*****-**-**-********-**-**-***********-********-*****-*****-*****-**-**-
----**-**-------**----**-------**----------------**----**-**-------**----------**-**-**-**----------**-**-**----------**-**----**-**-
-*****-**-*****-**-********-*****-*****-***********-*****-**************-*****************************-**-*****-********-*****-**-**-
----**-**----**-**-**----------**----**-**----------**----**-**-**----**-**-**-**-**-**-**----------------------**-**----**----**-**-
-**-**-********-**-**************-**-********-**-**-**-*****-**-**-********-**-**-**-**-***********************-**-********-**-*****-
-**----**-------**-**-------**-**-**-**----**-**-**----**----------**-**----**-------**----**-**-------**-------------**----**-**-**-
-********-**-**-********-**-**-********-********-**-**-*****-*****-**-*****-**-**-**-**-*****-********-*****-**-*****************-**-
-**-------**-**-**-------**----**-------**-------**-**-------**----**-------**-**-**-**-**----**----------**-**-------------**-------
-**-**-*****-*****-**-**-*****-********-**-**-*****-*****************-**************-**-**-***********-**-**-**-********************-
-**-**-**----**-**-**-**-**-**-**----------**-**-------**----------------**-------**-------**-**-------**----**----**-**-**-**----**-
-********-**-**-********-**-*****-*****-*****-*****-**-**************-*****-*****-**-*****-**-**-*****-*****-**-*****-**-**-**-*****-
-**-------**-**----**-------**-------**-**----**----**----------**-**-------**----**----**----**----**----**-**-**-------**----------
-**-**-********-**-*****-*****-*****-*****-********-**************-*****-********-***********-*****************-**-**-**************-
----**----**----**-**----**----**----**-------**-------**----**----**----------**-**----**-------------**-**-**----**-------**----**-
-**-********-*****-**-*****-**-**-********-********-********-*****-**-**-**-********-**-**-********-*****-**-**-**-********-**-*****-
-**-**-------**----**----**-**-**-**----------**-**----**-**----**-**-**-**-**-**----**----**----**----------**-**----**-------**----
-*****-*****-*****-**-**-***********-********-**-*****-**-*****-**-**-*****-**-********-*****-**-*****-***********-*****************-
-**-**-**-------**----**-**-------**-**----------**-**-**-------------**----**----**----------**-**-------------**----**-------------
-**-********-***********-**-********-*****-**-*****-********-*****-********-*****-**-********-***********-********-*****-***********-
-------**-**-------**----------**-**----**-**----**-------------**-**-**-------**----**-**----**----**----**-------**----**----------
-**-*****-*****-**-**-**-*****-**-*****-***********-**-**-**-*****-**-********-**-**-**-********-**-**************-**-**************-
-**-**----**----**-**-**----**----**-**----**-------**-**-**-**----**-------**-**-**----**----**-**----**----------------**----------
-*****-*****-*****************-*****-**-********-********-**-********-*****-**-**-********-**-*****-**-*****-**-*****-*****-********-
-**----**----**-------------**-**----**-**-------**----**-**----**----**----**-**-**-------**-**-**-**----**-**----**-**----**----**-
-*****-*****-********-**************-**-***********-**************-***********-**-********-*****-**-*****************************-**-
----------------------------------------------------------------------------------------------------------------------------------**$