25 37
#**----------------------------------
************-**-********-***********-
-------**----**-------**-**-------**-
-********-*****-********-**-**-*****-
-**----**----**-**----**----**-**----
-**-**************-*****-***********-
-------**-------**----**----------**-
-**-*****-*****-**-**-**-********-**-
-**-**----**-**-**-**----**-**----**-
-**-*****-**-*****-*****-**-**-*****-
-**-------------**-**-**-**-**-**-**-
-**-**-**-**-**-*****-**-**-*****-**-
-**-**-**-**-**-**----**-**-**-------
-********************-*****-********-
----------**-**----**-------------**-
-**-*****-**-**-**-********-********-
-**-**-------**-**----**-**----**-**-
-**-**-********-*****-**-**-*****-**-
-**-**-**-**----**-**-------------**-
-**-*****-********-**-*****-**-*****-
-**----**----**----**-**----**-------
-**-*****-********-*****-***********-
-**-------**-**-**----------**----**-
-***********-**-**************-*****-
----------------------------------**$