30 30
#**----------------------------------------------------------------------------------------
*********-***********-*****-**-*****-*****-*****-********-**-**-********-*****************-
-------**-**----**----**----**-**-**----**----**-**----**-**-**-------**-**-------**-**----
-*****-*****-********-***********-**-********-**-**-********-**-***********-********-*****-
-**----**----**----------------**----------**-**-**-**----**-**-**----**-**-**-**----**-**-
-*****-*****-*****-**************-**************-**-**-*****-*****-*****-**-**-**-*****-**-
----**-**-**----------**-------**-**----**-**----**-**-------------------------------**----
-********-*****-**-**-*****-********-*****-********-**-********-**************-**-********-
----**-**-**----**-**-**----------------**-------**-**-**----------**----**-**-**----**----
-**-**-**-***********-**-********-**-*****-**-*****-*****-*****-*****-*****-*****-**-*****-
-**-**-**-------**----**-**-------**-**-**-**-**-------------**----------**-**----**-**----
-*****-**-********-**-**-***********-**-**-**-*****-***********************-**-***********-
-**-**----------**-**----**-------**-**-**-**-**-**----------------**----**----**-**----**-
-**-**-***********-********-*****-*****-**-*****-**-***********-********-********-*****-**-
-**-------**----**----------**----**----------**----**-**-**-------**-**-**-**----------**-
-*****-********-**-**-*****************-**-**-**-*****-**-*****-*****-**-**-*****-*****-**-
-------**----------**-**-**----------**-**-**-**----**-**----------------**-------**----**-
-**************-**-**-**-***********-**-*****-**-*****-**-**-**************-*****-*****-**-
----------**----**-**-**-------**----**-**-**-**-------**-**-**----------------**-**----**-
-*****-**-***********-*****-*****-**-*****-**-**-**-***********-*****-*****************-**-
----**-**-**-**-------**----**----**----**-------**-------**-**----**----------**----------
-***********-**-**-**-*****-*****-********-********-*****-**-*****************************-
-**----------**-**-**----------**-------**----**-------**-**-**-**-**----------**----------
-*****-**-**-*****-*****-**-**-**-********-**-**-*****-**-**-**-**-**-********-***********-
----**-**-**----**-**----**-**-**-**-------**-**-**----**-------**----**----**-**----**----
-*****-********-*****-***********-**-***********-**-**-********-**-*****-********-**-**-**-
-**----------**-**-**-**----**----------**-------**-**-------**-------------**----**----**-
-**-**-*****-*****-********-**-**-********-*****-***********-********-*****-********-*****-
----**-**----------**----**----**-------**-**----------**-------**-------**-------**----**-
-***********-*****-*****-***********-**-********-********************************-*****-**-
-**-------**----**-------**----**----**-------**----**----------**----------**-**-**----**-
-**-*****************-**-**-*****-*****-********-**-********-*****-**-**-**-**-*****-*****-
-**----------**----**-**-------**----**-------**-**-**-**----**----**-**-**-------**----**-
-**-***********-********-********-*****-**************-**-*****-********-********-********-
-**-------**----**----**----**----**----------**-**-**----------------**-------**-**-------
-*****-**-**-*****-********-*****-**************-**-**-**-********-********-*****-********-
-------**-------**----------**----------**-**-**-**-**-**-**----**-**----------**-**-------
-**-********-**-********-*****-**-********-**-**-**-*****-**-********-*****-*****-**-*****-
-**-**----**-**----**----**----**----**-------------**-------**-------**-**----**-**-**----
-*****-*****-*****************-**************-**-**-**-*****-***********-*****-***********-
-**-**----**-**-------**-**----**-------------**-**-**-**-**----**----**-**-**----**-------
-**-**-********-**-**-**-*****-*****-**-*****************-*****-**-**-**-**-**-*****-**-**-
-------**-**----**-**-------**-**-**-**----**-**----**-------**-**-**-**-------**----**-**-
-**-*****-*****-**-**-*****-**-**-**-*****-**-**-*****-********-*****-********-**-*****-**-
-**-**----**----**-**-**-**-**-**----**-**----**----**-**----**-**-**----**----------**-**-
-*****-**-*****-********-*****-*****-**-***********-**-**-**-*****-*****-*****-***********-
-**-**-**-**-**-**-**-**-------------**----**----**----**-**-------**----**-**-**----------
-**-*****-**-**-**-**-********-********-*****-**-*****-**-*****-*****-**-**-**-***********-
-**-------**-------**----------**-------------**-**----------**----**-**-**-**-**-------**-
-********-********-**-**-***********-*****-**-*****-*****-***********-*****-*****-*****-**-
-**-**----**----**-**-**-**----------**----**-**----**-**-------**-**-------**----**----**-
-**-*****-**-**-**-**-*****-*****-*****-***********-**-**-********-********-*****-*****-**-
-**-------**-**----**-**-------**-**-------------------**-**----**-**-**-------**-**-**----
-*****-********-********-*****-**************************-**-*****-**-*****-********-**-**-
-------**-**-**----**----**----**-**-**-**----------------**-**-**----------**-------**-**-
-**-*****-**-*****-***********-**-**-**-**-**-*****-********-**-*****-********-**-********-
-**----**-**-**----**-**-**-**-------**-**-**----**----**-------**-------------**----**----
-********-**-*****-**-**-**-**-*****-**-*****-********-**-**-**-********-*****-**-*****-**-
-**----**----**-------**----**-**-**-------**-**----**-**-**-**----**----**----**-**-**-**-
-*****-**-***********-*****-*****-*****-***********-********-**************-********-*****
----------------------------------------------------------------------------------------*$
