49 73
#**----------------------------------------------------------------------
******-********-*****-********-**-*****-**-**-*****************-********-
-**----**----**-**----**----**-**----**-**-**-------------**----**----**-
-********-*****-***********-**-**************************-*****-**-**-**-
-**----**-**-**-**-**----**----------**-------**-**-**-**----**----**-**-
-*****-**-**-*****-*****-**-**-**-********-*****-**-**-*****************-
----**-**----------**-**----**-**-**-**-------**-**-**-------------------
-**-**-*****-********-********-*****-**-*****-**-**-*****-**-***********-
-**----**----------------**-------**----**----**-**-**----**----------**-
-***********-**-********-********-***********-**-**-*****-*****-********-
-**-**-------**----**-------**-------------------------**-**-**-**----**-
-**-*****-***********-********-**-***********-**************-********-**-
-------**-**----**-**-------**-**-------**-**----**-**-**-------**----**-
-***********-**-**-********-*****-********-**-*****-**-**-*****-*****-**-
-------------**-**----------------**-------**-**-**-**----**----**-------
-*****-***********-********-**-********-**-*****-**-**-**-*****-**-*****-
-**-**----**-**-------**----**-------**-**-**-**-**----**-**----**----**-
-**-*****-**-**-***********-**-*****-**-*****-**-**-***********-********-
-**----**----**----**-------**-**-------------**-**-------**-------**----
-*****-********-*****-*****-********-***********-*****-********-********-
-**----------**----**-**-**-------**----------**----------**-**----**-**-
-********-*****-*****-**-**-***********-*****-**-*****-*****-********-**-
-**-------**-**-**----**-------**-**----**----**-**-**----------------**-
-*****-*****-**-**-********-*****-**-********-*****-********-**-*****-**-
----**-------**-**-**-**----**----**-**----**-**----**-------**----**----
-*****-**-***********-*****-*****-**-**-**-**-**-********-**************-
-**----**----------**-**----**-------**-**-**----**-------------**-**----
-*****-***********-**-*****-*****-*****-**-***********-**-**-**-**-*****-
-**-------**-**-**----------**-**-------**-------**-**-**-**-**-**----**-
-***********-**-**-***********-********-*****-*****-*****-********-*****-
----**----------**-**-**----**-**----**-**----**----**-------**-------**-
-*****-**-*****-*****-*****-**-**-***********-**-*****-***********-**-**-
-**----**-**-------**-**-------**----**-**-**-------**-------------**-**-
-*****-**************-**-********-*****-**-**-**-***********-*****-*****-
----------------**----**-------------**-------**----**-**-**-**----**----
-*****-********-**-********-*****-**************-**-**-**-********-*****-
-**-**-**----**-**----**-**----**----------**----**----**----**-------**-
-**-*****-***********-**-**-*****-**-*****-**-*****-**-*****-***********-
-**----------------**-------**----**----**-**-**----**-**-------**-------
-**-********************-**************-**-*****************-*****-**-**-
----**----**----**----**----**----**-**-**-**----**----------**----**-**-
-*****-**-**-*****-**************-**-*****-*****-***********-*****-*****-
----**-**-------**----**-------------**----------**-------------**----**-
-*****-***********-**************-*****-**-*****-**-*****-**************-
-**-------**----**----**----**-------**-**-**----**-**----------**-------
-**-*****-**-*****-**-**-**-*****-**-**-**-********-*****-**************-
-**-**-**----**-**-**-**-**----**-**-**-**-**----**-**-**----**----**-**-
-*****-**-*****-**-********-*****-********-**-********-**-********-**-**-
----------------------------------------------------------------------**$