85 127
#**----------------------------------------------------------------------------------------------------------------------------
***-*****-**************-**************-*****-**-*****************************-********-********************-**-**-**-*****-**-
-**-**----**-**-**-**-**-**----------**-**----**-**----**-**-**----------**----**-------------**-**-**----**-**-**-**----**-**-
-***********-**-**-**-**-*****-*****-**-********-*****-**-**-*****-***********-*****-*****-**-**-**-**-********-*****-**-*****-
----**-------**----**-------------**-**----**-**-------**----------**----------**----**----**-**-------**-**----**----**-**-**-
-***********-**-*****-********-**-*****-*****-*****-*****-**-**-*****-*****-**-*****-********-*****-**-**-**-***********-**-**-
-**----**-**----**-**----**----**-**----**-**----------**-**-**----**----**-**-**-**-**-**-------**-**-**----**-------------**-
-*****-**-*****-**-********-********-*****-**************-*****-*****-**-********-**-**-********-**-**-**-**-*****-**-**-**-**-
-**-**----**-**-**-**-**-**-**----------**-**-------**-------**-**-**-**----**----------**----------**-**-**-**----**-**-**-**-
-**-**-*****-**-**-**-**-*****-**-********-**-**-**-**-***********-*****************-**-**-**************-*****-*****-********-
-**----------------**----**-**-**----------**-**-**-**-------------**-**-------**----**-**-**-------**-**-**-------**-------**-
-**-********-***********-**-********-*****-**-*****-********-*****-**-*****-**-*****-*****-**-**-*****-**-********-***********-
-------**----**-**-**----**----------**----**-**----**-------**-------**-**-**----**----**-**-**-**-------**----------------**-
-*****-**-**-**-**-**-**-**************-*****-**************-*****-*****-*****-**-*****-*****-********************-***********-
-**----**-**----------**-**----**----**-------------------**-**-------**-------**----**-**-**-------**-**----**----------**----
-********-***********-**-*****-*****-**-**-**************-********-**************-**-*****-**-********-*****-**-*****-********-
-------**-**-**----**-**-**----**-------**-**-**----**----------**----**-**-**----**----------------**----**----**----**-------
-**-**-*****-**-********-*****-*****-*****-**-*****-**-*****-*****-*****-**-**-*****-********-**-**-*****-*****-*****-**-**-**-
-**-**-**----------**----------**----**-------**-------**-**-------**-**----**-**-------**----**-**-**-**-------**----**-**-**-
-*****-********-**-********-*****-**************-*****-**-*****-*****-*****-********-********-********-*****-**-********-*****-
----**-------**-**----**-**-**-**-**----**----**-**----**-**-------**-------**-------**-------**-------------**-**----**-**----
-**-*****-*****-********-**-**-**-*****-*****-***********-*****-**-********-*****-*****-*****-**-********-********-********-**-
-**----**-**----**-**----**-**-**----**-------------**-------**-**----------**-------**----**----------**----**-**-------**-**-
-*****-********-**-**-*****-**-**************-********-**-**-**-**-*****-********-***********-********-**-**-**-**-*****-*****-
-**----------**-**----------------**----**----**-**-**-**-**-**-**----**-**-**----**----**----**-**----**-**----**-**-**-**-**-
-**-*****-**-**-*****-*****-***********-**-*****-**-**-**-**-**-***********-********-*****-*****-*****************-**-**-**-**-
-**-**----**----**----**-**-**----**-------------------**-**----**-**-**----**----**----**-**----------------**-**-**----------
-***********-***********-**-**-*****-***********-**************-**-**-*****-**-*****-***********-**************-**-***********-
----------**----**----**----------**-**-------**----**-------**-**----**-**-------------------**-**----**----**-------**-**-**-
-*****-*****-*****-**-***********-********-**-*****-********-**-**-*****-**-*****-*****-**-*****-**-********-**-*****-**-**-**-
-**----**-**-**----**-**-**-**----**----**-**----**----**----**-**----**----**-**----**-**----------**-**-**-------**-**-------
-********-***********-**-**-*****-**-********-*****-********-**-**-********-**-**-*****-**-**-*****-**-**-**-**************-**-
-**-**-**----**----**----**-------**-------------**----**-------**----------**----**-**-**-**-**-**-**-------**-------**----**-
-**-**-**-********-**-**-**-***********-**-**-********-**-*****-**-*****-***********-*****-**-**-**************-********-*****-
-------**-------**-**-**----------**-**-**-**-**----**-**-**----**----**----**-**----------**-**-**----**-**-------**----**-**-
-**************-**-********-**-**-**-**-**-********-**-********-**-**-*****-**-***********-**-**-*****-**-*****-*****-*****-**-
-**-**----**-**-**-**----**-**-**-**----**-------------------**-**-**-**-**-**-**----------**-**----**-**-------**-**-**-**-**-
-**-**-*****-**-**-**-*****-*****-*****-********-*****************-**-**-*****-***********-********-**-********-**-*****-**-**-
-------------**----**-**-**-**-**-**-------**----**----------------**-**----**-**----**-------------**----**-**-------**-------
-**-********-**-*****-**-**-**-********************-*****-**-**-********-**-**-*****-*****-********-**-**-**-**-*****-********-
-**-**-**-------**-**----------**-**-**----**----------**-**-**-**-------**-**-------------**-------**-**-**----**-**----**----
-*****-***********-**************-**-**-*****-********-********-***********-*****-**-**-***********-*****-********-**-********-
-**-**-------------**----**-------**-**-------------**-**-------------**----------**-**-**----**-**-**-**-**----**-------**----
-**-*****-********-*****-********-**-***********-*****-*****-*****-**-**-***********-**-**-**-**-**-**-**-**-**-**-*****-*****-
----**-------**-**----------**----------**-------**-**-**-**-**----**-**-**-**-**-**-**----**----**----**-**-**-**----**-------
-*****-*****-**-********-***********-**************-**-**-***********-*****-**-**-***********************-**-*****************-
----**----**-------**-**----------**-------**----------**----------**-**----**-------**-------**-------------**----------**----
-********-**-********-********-***********-**-**-**-**-*****-********-**-***********-*****-*****-*****-********-********-*****-
-**-------**-------------**----**-------**----**-**-**----**-**-**----**-------**-------------**-**-------**-------**-**-**----
-*****-**-***********-*****************-********-********-**-**-**-**-**-********-**-*****-**-**-**-**-********-*****-********-
-**-**-**-**----**----**-------**-**----------**-**-------**-------**-------------**----**-**-**-**-**----**----**-**-------**-
-**-*****-**-********-**-**-*****-**-*****-**-*****-********-*****-***********-**-*****-**-********-***********-**-*****-*****-
-**-------**-------**----**-**-**-------**-**-**----**----**-**-**-**-**-------**-**----**----**----------**----**----**----**-
-**-********-**-**************-**************-**-**-**-*****-**-*****-*****-**************-**-*****-***********-**-********-**-
-------**-**-**-**-**-**-**----**----**----**-**-**-------**----**----**-------**----**----**-**-------**-**----------**----**-
-*****-**-*****-**-**-**-*****-**-*****-**-**-*****-*****-**-*****-**-********-*****-**-********-********-*****-**-********-**-
-**-------------------**-**----------**-**-**-**-**----**-**-------**-------**----**----------**----------**----**----**----**-
-**-********************-********-********-**-**-**-********-*****-*****-**-********************-*****-**-*****-*****-*****-**-
-**----**-------------------------**-**-------**-**-**-------**-------**-**-------**----**-**-**-**-**-**-**-**-**----**-------
-**************-*****-*****-*****-**-********-**-*****-*****-**-**-***********-**-**-*****-**-*****-**-*****-**-*****-**-**-**-
-**-------**----**----**-**-**-**----------------**----**----**-**----------**-**-**----------**-**-------------**-**-**-**-**-
-**-**-**-********-*****-*****-*****************-**-**-**-********-*****************-********-**-*****-********-**-**-*****-**-
-**-**-**-**----------------**----------------**-**-**-**----**-------**----------**-**----**----------**-**----**----**----**-
-********-*****-*****-*****-**-**-**-**-*****-**-**-**-**-**-**-**-*****-*****************-*****-*****-**-*****-**-**-*****-**-
----**-------------**-**----**-**-**-**----**-**-**-**-**-**-**-**-------------------**-**----**----**-**-**----**-**-**----**-
-**************-***********-***********-********-*****-*****-***********-********-*****-**-***********-**-**-**-**-*****-*****-
----**-**-**-------**-------**----**-------**-**-**-**-**-**-------**-------**----**----**----------**----**-**-**----------**-
-**-**-**-**-**-**-**-*****-**-********-**-**-*****-*****-**-*****-*****-********-**-*****-********-**-***********-**-********-
-**-**-**-**-**-**-**----**-------------**-**-**-------**----**-**-**----**-**----**----**----**-------**-------**-**-**-------
-**-**-**-***********-*****************-*****-*****-**-*****-**-***********-**-**-*****-*****-********-********-**************-
-**-------**-**-**-**----------**-------------**----**-**-------**-------------**----**-**-**-**-------------**-**----**-------
-***********-**-**-*****-***********-**-********-**-*****-********-*****-**************-**-*****-********-*****-**-********-**-
----**-**----------**-**-------**----**-------**-**-**-------**-**-**-**-------**-**-**----**-**-**----**----------**-**----**-
-*****-**-***********-**-********-*****-**-**-**-********-*****-**-**-***********-**-*****-**-**-**-**-**-*****-**-**-**-*****-
----**----**----**-------**----**-**----**-**----------------**-**----**----------**-------------**-**-------**-**-**----**----
-**-*****-*****-***********-**-**-*****-*****-**************-**-*****-**-*****-*****-**************-**************-**-********-
-**-**-------------**-------**-**----**-**----**----**----**-**-**----**----**-**----------**----**----**-------**-**-------**-
-********-**-***********-*****-********-**-**-**-*****-********-*****-**-***********-**-**-**-*****************-**-*****-**-**-
-**----**-**-------**-**----**-**-**----**-**-**----------------------------------**-**-**-------------**-------**-**-**-**-**-
-*****-***********-**-**-********-********-***********-*****-***********-********-**-**-**************-*****-********-********-
-**----**----**-------**-**-------**----**----**-**-------**-------**-**----**----**-**----------**----**-**----**----**-------
-**-**-**-***********-**-**-********-***********-*****-********-*****-**-********************-**-********-**-*****-***********-
-**-**-**-**-**----**----**----------**----**-------------**-------**----------**-------**-**-**-**-**----**----**-------**----
-**-*****-**-**-*****-**************-**-********************************-********-********-********-**-*****-*****-***********-
----------------------------------------------------------------------------------------------------------------------------**$