100 101
-#-*********-*************-*-*****-*********-*****-*-***-*********-*****-*******-***-***-***********-
-*-*-----*---*---*-------*-*-*---*-*---*---*-*-*-*-*-*-*-*-*-------*-*-*-*-----*-*-*-*-*-*-------*---
-*-*-***-*****-*-***-*****-*-*-*-***-*-***-*-*-*-***-*-***-***-*****-*-***-***-*-*-*-*-***-*****-***-
-*-*-*-*-------*---*---*---*-*-*-----*---*---*-*-----*-------*-*-----*-----*---*---*-*-----*---*---*-
-***-*-***********-***-*-***-*-*********-*****-*******-***-***-*****-***-*-*******-***-*****-***-***-
-*-------*-----*-----*-*---*-*-*---*-----------------*---*-*---*-------*-*-*-----*-----*-----*---*-*-
-*******-*-***-*****-*-*****-*-*-*-*-***************-*****-*-***-*******-*-*-***-*******-***-***-*-*-
-------*---*-*-----*-*---*---*-*-*-*-*-------------*---*---*-*---*-------*-*-*-*---------*-*---*-*---
-*******-***-*-***-*-***-*-***-***-*-*****-***-***-*-***-***-*-***-***-***-*-*-*-*****-***-***-*-***-
-----*---*---*-*-*-*---*-*-*-------*-----*-*-*-*-*-*-*---*---*-*---*-*-*-*-*-*-*---*-*-*-*-*---*-*-*-
-***-*****-*****-*****-*-*-*-*******-***-***-*-*-*-*-*-*-*-***-*-***-*-*-*-*-*-***-*-***-*-*-***-*-*-
-*-*-------------------*-*-*-*-----*-*-------*---*-*-*-*-*-*---*-*---*-*-*-*-*---*-----*-*-*-*-----*-
-*-*******-*****-*****-*-*-***-*-***-*****-***-***-*-***-*-***-***-***-*-***-*-*-*****-*-*-*-*-*****-
-*-------*-*---*-*---*-*-*-----*-*-------*-*---*---*-----*---*-----*-----*---*-*-----*---*---*-*---*-
-*-*****-*-***-*-***-***-***-*****-*****-*-***-***********-***-*****-***-***-***-***-***-*-***-***-*-
-*-----*-*-*-*-*---*-------*-*-----*-*-*-*---*-*---------*-*---*-----*-*-------*-*-----*-*-*-----*-*-
-*-***-***-*-*-***-*-***-***-***-***-*-*-*-***-*-*******-*-***-*******-*******-***-*****-*-*******-*-
-*-*-*-*-----*---*-*-*-*-*-----*-----*-*-*-*-----*-----*-----*---------------*---*-*-----*---------*-
-*-*-*-*-*****-*-***-*-*-*-***-*******-***-*******-***-*****-***-*********-***-***-*-*************-*-
-*-*-*-*---*---*-----*-*-*-*-------------*---------*-------*---*-*-------*-*---*---*-------*-----*-*-
-***-*-***-*-*********-*-*-*****-***-*****-***************-***-*-*-*******-*****-*-*******-*-***-*-*-
-*---*---*-*-*---------*-*-----*-*-*-*---------------*-*---*-*-*---*-----*-------*-------*-*-*-*---*-
-***-***-*-*-*-*********-*****-***-*-***-*********-***-*-***-*-*****-***-***-*********-***-***-*****-
---*---*-*-*-*-*-------*-----*-----*---*-*-------*-*-----*---*-------*-*---*-*-------*-*-------*-----
-*****-*-*-*-*-*****-*******-*********-*-*******-*-*-*****-*-***-*****-***-*-***-*****-*******-*****-
-*-----*-*-*-*-----*-*-----*---------*-*-------*-*-*-*-----*---*-----*---*-*-----*-----------*-----*-
-*-*-***-***-***-***-*-***-*******-***-*********-***-***-*-***-*******-*-*-*-***-*********-***-*-***-
-*-*-*---------*-*-*---*-*---------*---------------*---*-*-*-*---------*-*-*-*-*-------*-*-*---*-*---
-***-*-*********-*-*-***-*********-***-*******-*****-***-***-*******-*****-***-*****-***-*-*-***-***-
-*---*-----*-----*---*-----------*---*-*---*-*-*-----*-----*-------*-*-------------*-*-----*-*-----*-
-*-***-***-***-*-*****-*****-***-*****-***-*-*-*-*****-***-*******-***-***-***-*****-*-*****-*-***-*-
-*-*---*-*---*-*-------*---*---*---------*-*---*-*---*-*-*---------*---*-*-*-*-*-----*-*-----*-*-*-*-
-*-***-*-***-*****-*****-***-***-***-*****-*****-*-***-*-***-*****-***-*-***-*-*****-*-***-*****-***-
-*---*-*---*-----*-----*-*---*-*-*-*-*-----------*-----*---*-*---*---*---*---*-----*-*---*-----*-----
-*-*-***-*-***-*********-*****-***-*-***-***-*****-*****-***-***-***-***-*-***-*****-***-*****-*****-
-*-*-----*---*-------------*-------*---*-*-*-*---*-*-----*-*---*---*---*---*---*-------*-----*-----*-
-*****-*****-*****-***-***-*-*****-*-***-*-*-*-***-*-*-***-***-***-***-*****-***-*********-*-*****-*-
-----*-*---*-----*-*-*---*-*-*---*-*-*---*-*-*-----*-*-*---*-----*---*-----*-*---*-------*-*-----*-*-
-***-*-*-***-***-***-***-***-*-***-*-*-***-*-***-***-*-*-***-*****-*-*****-*-*****-*****-*-*-*****-*-
---*-*-*-*-----*-------*-----*-*---*-*-*-*-----*-*---*-*-*---*-----*-----*-*-------*---*-*-*-*-----*-
-***-***-***-*****-*****-***-*-***-*-*-*-*-*****-*****-*-*-*-*******-***-*-*****-***-*-*-***-*-***-*-
-*---------*-*---*-*-----*-*-*---*---*---*-*-------*---*-*-*-------*-*---*-------*---*-*-*---*-*-*-*-
-*****-***-***-*-*-*****-*-*-*-*-***-*****-*******-*-***-*****-*******-***-*******-***-*-*-***-*-*-*-
---*-*---*-----*-*-----*-*-*-*-*---*-----*-------*-*-*---------*-------*-*-*-------*-*-*-*-*---*-*---
-***-*********-***-***-***-*****-***-***-***-***-***-***********-***-***-*-*-*******-*-***-*****-***-
-*---*-------*-*---*-*-----------*-*---*---*---*-----------------*-*-*-----*-*-------*-------------*-
-*-***-*****-*-*-***-*******-*****-*******-*****-*******-*****-***-*-*****-***-*****-*-*******-*-***-
-*-----*---*---*-*---*-------*---*-----*-------*-----*---*-*-*-*-*-*-----*-----*-----*-----*-*-*-*-*-
-*-***-***-*-***-*-***-***-***-***-***-*-*****-*-***-*****-*-*-*-*-*****-*******-***-*******-***-*-*-
-*-*-*-*---*-*-----*---*-*-*-------*-*---*---*-*-*-*-----*-*-*-*-*-----*-----*---*-*-----------*-*---
-***-***-***-*****-*****-*-*********-*******-*-***-*****-*-*-*-*-*-*****-***-*****-***-*******-*-***-
-*-------*-------*-*-----*-------------------*---------*-*-*-*-*-*-----*-*-*---------*-*-*-----*-----
-*******-*******-*-*****-*****-***-*****-***-***-*****-*-*-*-*-*-*****-*-*-*********-*-*-*******-***-
-------*-----*---*-----*-*---*-*-*-----*-*-*-*-*---*-*-*-*-*-*-*-----*---*-----*-----*-*-----------*-
-*****-*-*****-***-***-*-***-***-*****-*-*-*-*-*****-*-*-*-*-*-***-*-***-*-***-*-***-***-*********-*-
-*---*---*-*---*-----*-*---*---------*-*-*-*-*-------*-*---*-----*-*---*-*---*-*-*-*-----*-*-----*-*-
-***-*****-*-***-*****-*-***-*-*********-*-***-***-***-***-***********-*-*-***-*-*-*******-***-*-*-*-
-*-*---------*---*---*-*-*---*-*---------*-*---*-*-------*-*-----------*-*-*---*-*-----------*-*-*-*-
-*-***-*******-***-***-*-***-*-*-*****-***-*-***-*******-*-***-*****-***-*-***-***-*****-*****-***-*-
-*---*-*-------*-*-----*---*-*-*-*---*-*-----*---------*-*-----*---*-*-*-*---*---------*-*-----*---*-
-***-***-***-***-*****-***-*-***-*-***-*-***-*-***-*****-***-***-*-***-*-*-***-*********-*****-*-***-
---*-----*---*-------*---*-*-----*-*---*-*-*-*-*---*-*-----*-*---*-----*-*-*-*-----*-*-------*-*---*-
-*-*-***-*****-*****-*****-*-*****-***-***-*****-***-*-*****-***-*******-***-*******-*-*******-*-***-
-*-*-*-*---*---*---*-------*-*-------*-----------*-----*-----*-*-----------*---------*-*-------*-*---
-*-***-***-*-***-*-*-*******-*****-*-***********-*-*****-*****-***-***-*****-***-*****-***-***-*-***-
-*-------*---*---*-*-*-----*-----*-*---*-------*-*-*-----*-------*-*-*-*-----*-*---------*-*---*---*-
-*******-*****-***-*-***-*-***-***-*****-***-*****-***-*-*-*****-***-*****-***-***********-*-***-***-
---*-*---------*-*-*-*-*-*---*-*---*-----*-*---------*-*-*---*---------*---*---------------*-*---*-*-
-***-*-*********-*-*-*-*-*****-*-***-*****-*********-*-*******-*******-*-***-*-*********-***-***-*-*-
-*-----*---*---*---*---*-*-----*-*---*-----------*-*-*-------*-*-----*-*-*---*-*---*---*---*---*-*---
-*****-***-*-***-***-***-*-*****-*-***-*******-***-*-***-*****-*-***-*-*-*-***-*-*-*-*-*******-*-***-
-----*---*-*---*-*---*---*-*-------*-----*---*-*-------*-------*---*-*---*-*-*-*-*-*-*-----*---*-*-*-
-***-***-*-***-*-***-***-*-*********-***-***-*-*******-***-*****-***-*****-*-*-***-*-***-***-***-*-*-
-*-*---*-*---*-----*-*-*-------------*-*-*-*-*-------*---*-*-----*---------*-*---*-*-*-*-*---*-----*-
-*-***-***-***-*****-*-*-*******-*****-*-*-*-*-*****-***-***-***-***-*******-*-***-*-*-*-*-***-*****-
-*---*-----*-*-*-----*-*-*-*---*-*-----*-*-*---*-*---*-*-----*-*-*-*-*-*-----*-*---*-*---*-*---*---*-
-***-*******-*-*-*****-***-*-***-*-*-***-*-*****-***-*-*-***-*-***-***-*-*****-***-*-*-***-*-*****-*-
-*-*-----------*-*---------*-*---*-*-*-------------*-*---*-*-*---------*---------*-*-*-*---*-----*-*-
-*-***-***-*****-*********-*-*****-***-*******-***-*-*-***-*-*-*******-*-*******-*-*-*****-*******-*-
-*---*-*-*-*-----------*---*-------*-----*---*-*-*-*-*-*---*-*---*---*-*-*-----*-*-*-----*---------*-
-***-***-***-*********-*-***-***-***-*****-***-*-*-*-*-*-*-*-*****-*-*-*-*****-***-***-***-*********-
---*---------*-*-----*-*-*-----*-*-----*-----*-*-*-*-*-*-*-*-------*-*-*-----*-------*-----*---------
-*-***-***-***-*-***-*-*-*-*****-*-*****-***-***-*-*-***-*-*****-***-*-*****-*-***-*-*******-*******-
-*---*-*---*---*-*---*-*-*-*-*---*-*-*---*-*-----*-*-----*-*-----*-*-*---*---*-*-*-*---------*-------
-*****-*****-***-*****-*-*-*-*-***-*-*****-*-***-***-*****-*-*****-***-*-***-***-*-***********-*****-
-*-----*-----*---*-------*-*---*-----*-----*-*-*---*-*---*-*-*---------*---*-----*-*-----*-----*---*-
-*****-*****-***-*********-***-*-***-*-*****-*-*-***-***-*-***-*-*********-***-***-***-***-*******-*-
-----*---------*-----------*-*-*-*-*---*-----*---*-----*-*-----*-*-*-------*---*-------*---*-----*-*-
-***-***-*****-*-***-*****-*-***-*-*-***-*****-***-***-*-***-*****-*****-***-***-*******-***-***-*-*-
-*-----*-*---*-*-*-*-*-----*-----*-*-*---*-*---*---*-*-*---*-*---------*-*---*---*-*---*-*---*-*---*-
-***-***-***-*-***-*-*-*****-*****-***-***-*-***-***-*-*-*-*-*-*-*******-*****-***-***-*-*-*-*-*****-
---*-*---*-*-*-----*-*-*-------*---------*-*-*---*---*-*-*-*-*-*-*-----*-------------*---*-*-*-----*-
-***-*-***-*-*******-*********-*-*********-*-***-***-*-***-*****-*-***-*-***-*******-***-***-*-*****-
-*-*-*---*-*-------*---------*-*-------*-------*---*---*---------*-*-*-*-*-*---*---*---*---*-*-------
-*-*-***-*-*******-*-***-***-***-*******-*****-***-*****-*********-*-*-***-***-***-***-*****-*-*****-
-*-----*-------*-*---*-*-*-*-----*-------*-*-----*-*-----*---------*---------*---*---*-------*-*---*-
-*****-***-***-*-*****-***-*-*****-*******-*-*****-*****-*-*******-*****-***-***-***-*******-*****-*-
-*---*---*-*-*-------------*-*-----*-------*-*-----------*-*---*---*---*-*-*---*---*-------*-------*-
-***-*******-***************-*************-***************-***-*******-***-*********-**************$-
---------------------------------------------------*-------------------------------------------------