41 61
#**----------------------------------------------------------
******-********-**-**-*****-**-*****-*****-**************-**-
----**-**----**-**-**----**-**----**----**-**-**-**-**-**-**-
-***********-**-********-********-********-**-**-**-**-*****-
-**----**-**----**----**-**-------**----**----------**-**----
-*****-**-**-**-**-**-*****-*****-*****-**************-*****-
-**-**-**----**----**----**-**----**----------------**----**-
-**-**-**-*****-********-*****-********-********-*****-*****-
-**-**-------**----**----**-**----**----------**-------------
-**-***********-***********-********-*****************-*****-
-------**-**-------**-------**-**-------**----**-------**-**-
-**-**-**-*****-********-**-**-***********-**-*****-*****-**-
-**-**-**----**-**-**----**----------**----**-**-**----**----
-********-**-**-**-*****-**-********-*****-**-**-***********-
----**----**-**-------**-**-**----**----**-**-------------**-
-*****-*****-**************-*****-*****-*****-**-**-**-*****-
----------**----**----**----**----------**-**-**-**-**-**----
-*****-*****-*****-***********-*****-*****-*****-*****-**-**-
-**-------**----------------**-**-**-**-------------**-**-**-
-**-*****-*****-***********-**-**-*****-*****-**************-
-**----**-**----------**----**----**----**----**-**-------**-
-*****-**-**-*****-***********-**-*****-*****-**-*****-*****-
-**----**-**-**-**-------**----**-------**----**-**-------**-
-********-**-**-**-**-*****-**************-*****-*****-*****-
----**----**----**-**-------**-------**-**-**----**----**----
-********-**-********-**************-**-*****-********-*****-
-------**-**-------**-**-------**-**----**-------**----**-**-
-**-********-*****************-**-*****-**-**-**-*****-**-**-
-**-**-**-------**-**----------**----**----**-**-**-**-------
-*****-***********-*****-*****-**-********-********-********-
----**-**----**-**-**-**-**----**----**-------**-**-**----**-
-*****-**-*****-**-**-*****-********-**-********-**-**-**-**-
----------**----**-------**-**----------**-**----------**----
-*****-**-**-*****-********-*****-**-*****-*****-*****-**-**-
-**----**-**-**----**-**----------**----**----**-**----**-**-
-*****-*****-**-*****-**-**-**************-********-**-*****-
-**-**----**-**----------**-**----------------**-**-**----**-
-**-*****-**-**-***********-**************-*****-*****-**-**-
----**----**-------**-**----**-------**----**----**----**-**-
-***********-********-********-***********-**-**************-
----------------------------------------------------------**$