15 15
#**-------------------------------------------
******************************-*****-********-
----------**----**----------**----**-**-------
-**************-**-**-********-**************-
-**----**-**-------**----**-**-------**-**----
-**-*****-*****-*****-**-**-**-**-*****-*****-
-**----**----------**-**-**----**----**----**-
-*****-*****-*****-********-********-**-**-**-
----------------**-**-**----**-**----**-**-**-
-*****-**************-*****-**-**-********-**-
-**----**-------**-**-------**----**----**-**-
-********-********-***********-*****-*****-**-
----**-**-------**-**-**----**----------**-**-
-*****-**-*****-**-**-**-*****-***********-**-
-**-**-**-**----**-**-------**-**-------------
-**-**-*****-*****-**-*****-*****-********-**-
-**----**----------**-**-------------**-**-**-
-*****-**-*****-********-*****-********-*****-
----**----**----**----**----**----------**-**-
-********-*****-**-*****-**-*****-********-**-
-------**-**-**-**----**-**----**----------**-
-***********-**-**-*****-**-*****************-
----------**-**-**-------**-------**-------**-
-***********-**-**-*****-**-**-**-*****-*****-
----------**----**-**----**-**-**-**----**----
-*****-*****-**-**-*****-*****-********-*****-
----**----**-**-------**-**----**-------**----
-**-**-*****-*****-********-*****-**-********-
-**-**-**----**-**----**----**-**-**----**----
-**************-**************-*****-********
-------------------------------------------*$
