10 10
#**----------------------------
***-*****-*****************-**-
-**----**----**-**----**----**-
-*****-********-**-*****-*****-
-**-------**-**-------**-**----
-**-**-**-**-**-*****-**-*****-
-**-**-**-**-------**-**-**----
-*****************-*****-**-**-
----**----**-------**-**-**-**-
-**-**-********-*****-**-*****-
-**----**----**----**-**-**----
-*****-*****-*****-**-*****-**-
----**-**----**-------**----**-
-**-**-**-***********-**-*****-
-**-**----**-**----------**-**-
-*****-*****-********-*****-**-
-**----**-------------**-**----
-***********************-**-**-
-**-------**----**-**----**-**-
-********-**-*****-*****-*****
----------------------------*$
