28 28
#**----------------------------------------------------------------------------------
***************************-***********-**-**-*****-***********-********************-
-------**----**-------------**----**-**-**-**-**-------------**-**-**-**-**----------
-***********-**-**-*****-**-*****-**-********-*****************-**-**-**-*****-*****-
----**-**-**----**-**----**----**-------------------**-**-------**----**-------**-**-
-**-**-**-********-**-**************-**-**************-********-**-********-*****-**-
-**----------**----**-**-------**-**-**-**-**-**-------**----**----------**-**-**-**-
-********-*****************-**-**-**-*****-**-*****-*****-**-**-**-*****-**-**-**-**-
-**----**-**----------**----**-**----**-**----**-------**-**----**-**----**-**-**----
-*****-********-**-**-**-**************-**-**-********-*****-********-**-*****-**-**-
----**-------**-**-**-**-**-**-**----**----**-**----**----**-------**-**-**----**-**-
-**-*****-***********-**-**-**-*****-**-**-*****-********-**-**-*****-********-*****-
-**-------------**----**-**-**-**----**-**----**----------**-**-**-------**-------**-
-*****************-*****-**-**-**-********-*****-**-**-***********************-*****-
----------**-**-**-**----**-**-------**----**----**-**----**----**-**----**-**----**-
-********-**-**-**-*****-**-********-*****-**-********-*****-*****-**-*****-*****-**-
----**-**-**-**-------**-------------------**-**----**-**-**-------**-**-------------
-*****-*****-**-********-********-**-*****-**-**-**-*****-**-**-*****-**-*****-*****-
-**----**-**----------**----**-**-**-**----------**-**-------**-**----**-**----**----
-**-*****-********-**-*****-**-********-**-**-********-********-*****-**-**-********-
-**-------**----**-**-**----------**-**-**-**----**----**-**-------**-**-**-------**-
-********-*****-**-*****-*****-*****-********-********-**-**-*****-**-**-********-**-
----------------**-**-**-**-------------**-**----**-**-**-**-**----**-**-------**-**-
-**-********-*****-**-**-*****-********-**-**-**-**-**-**-**-*****-**-**-*****-*****-
-**----**----**-------**-**-**-**----------**-**-**-**----**-**----**-**----**-**----
-*****************-**-*****-**-*****************-**-**-***********-**-**-**-**-*****-
-------**----------**----**-**-------------**-------**----**-**-------**-**-**-**----
-********-**-*****-********-**-*****************************-*****-**-**************-
----------**-**-**-**-------**-------------**-**----------**-------**-**----**-------
-***********-**-*****-***********-********-**-********-********-**-********-**-**-**-
-------**----------**-**-**----**-**----**----------------**-**-**-------**----**-**-
-***********-**-*****-**-**-********-*****-********-**-*****-**-*****-**************-
-------**-**-**-**-------**-------------**-**----**-**-**-------**----**----**----**-
-********-*****-********-*****-********-*****-*****-*****-*****************-*****-**-
-**-**----**----------**----**-------**----**----**-**-------------------**-**----**-
-**-**-********-*****-**-**-*****-*****-********-**-**-*****-**-**-**-*****-**-*****-
-**----**-**-**----**----**----------**-**-**-------------**-**-**-**----------**----
-**-**-**-**-***********************-**-**-********-********-**-********-**-*****-**-
-**-**-------**----------**----**----**----**-------**----**-**----**-**-**----**-**-
-**-***********-*****-*****-********************-*****-********-*****-*****-*****-**-
----**-**----**----**----**----**-**----**-**-**-**-**----**----**----**-**-**----**-
-**-**-*****-**-**-********-*****-*****-**-**-**-**-**-**-***********-**-**-**-*****-
-**-**----------**-**-**-------**-**-**-**----**-------**-**-------------**-**----**-
-********-***********-*****-*****-**-**-**-*****-***********-***********-**-**-*****-
-**-------**----**----------------------**-------------**----**----**-**----------**-
-********-*****-********-***********-*****-**-**-***********-**-*****-**-*****-*****-
----**-**-------------**----------**-**----**-**-------**-**----------**----**-**-**-
-*****-**-**-**-*****-**-**************-**-**-**-********-*****-**-**-***********-**-
-**-------**-**----**-**----**-------**-**-**-**-**-------**-**-**-**-------**-------
-***********-***********-**-*****-**-********-********-*****-*****-*****-***********-
-**-**----------**----**-**-**-**-**-**----**-**-**----------**----**-**----**-**----
-**-**-**-*****-**-**-**-*****-**-**-*****-*****-*****-**************-********-*****-
-**-**-**-**-------**----**-------**----------------------**----**-------**----**-**-
-**-**-*****-*****-**-**************-**-**-***********-**-**-***********-**-**-**-**-
-**----**-**-**----**-------**-**-**-**-**-------**----**-**----------**-**-**-**-**-
-********-*****-**************-**-*****-********************-***********-*****-**-**
----------------------------------------------------------------------------------*$
