96 145
#**----------------------------------------------------------------------------------------------------------------------------------------------
***-**-*****-**-********-***********-**-*****-**************************-*****-**-***********-**-*****-**-**************-**************-**-*****-
-**-**----**-**----**-------**-**-**-**-**----**----**-**----**----**-------**-**-------**----**----**-**----------**-------**-**-------**----**-
-**************-*****-********-**-*****-**-********-**-*****-*****-*****-********-*****-********-**-********-*****-**-**-*****-**-**-***********-
----**-------**----**-**-------**----**-**-**-------**-**-------**-**----------**-**-**----**-**-**----**----**-**-**-**-**----**-**-**-------**-
-***********-*****-**-********-*****-**-**-**-**-*****-********-**-**-*****-********-**-*****-***********-*****-***********-**************-*****-
----------**-------**-**-**-**-------**-**-**-**----**----**-------**----**----**-**----**-**----------**-**-------**-**----**-**-**----------**-
-**************-*****-**-**-********-**-***********-**-**-*****-*****-***********-********-**-*****-***********-*****-**-*****-**-*****-*****-**-
-------**----**----**-**-**-**----**----------**----**-**-**----**----------**-**-**-------**----**----------**-------------**-**-**-**-**-**-**-
-***********-*****-*****-**-*****-**************-********-*****-**-**-*****-**-**-**-**-**-***********-********-**-*****-*****-**-**-*****-**-**-
----------------**----**----**----**-**-------**-------------**----**-**----------**-**-**----------------**----**-**-**-------**----------**----
-**-*****-*****-***********-**-**-**-**-***********-***********-**-**-**************-**-*****-**-********-**-********-*****-***********-********-
-**-**-------**-**----------**-**-**-------**-------**----**-**-**-**-**-**-**----**-**----**-**-**----------------**----------**-**----**-**----
-***********-***********-*****-*****-********-********-*****-**-**-*****-**-**-***********-**-*****-********-********************-*****-**-*****-
----**-------------**-**-**-**-**-**-------**----**-------------**-**-------**----------**-**----**-**-**-------------**-------------**----**----
-*****-*****-**-**-**-**-**-**-**-*****-**-*****-********-*****-*****-**************-**-*****-********-**-*****-*****-*****-********-**-**-*****-
-**-------**-**-**----**-------**----**-**----**----------**-------**-**-**----**-**-**-------**-**----------**-**----**-**-------**-**-**----**-
-**************-*****-**-********-********-********-*****-********-**-**-**-*****-*****-********-*****-*****-********-**-**-*****-*****-**-**-**-
----------**----**----**-**-**-**-**-**-**-**-------**----**----------------------------------**-**----**----**-**-------------**----**-**-**-**-
-**-**-***********-**-**-**-**-**-**-**-**-*****-***********-**-**-**-********-**-********-*****-**-***********-********-********-***********-**-
-**-**----**----**-**-**----**----------**-**----------**----**-**-**----**----**-**-**----**-**-------**----**-**----**-**----**-**-**----**----
-*****-*****-*****-**-**-***********-*****-**************-*****************-********-**-*****-**-**-**-*****-**-**-*****-**-*****-**-**-**-*****-
-**-**----**----**-**-**-**----**-**----**----**-**----**-**----**-------**----**-------**-**----**-**----**----------**-**-------**-**-**----**-
-**-*****-**-*****-*****-**-**-**-**-*****-**-**-**-********-***********-*****************-********-********-*****-*****************-**-*****-**-
----**----**-**----**-------**-------**-**-**-------**----**-------------**-**-**-------**-**-------**----------**----**-------**-------**-**----
-********-**-**-********-********-*****-*****-**-*****-**-*****-**-*****-**-**-********-**-*****-**-***********-*****-**-**-********-*****-*****-
-------**-**----**-**----**----**-------**-**-**-**----**-**----**-**----**-**----------**----**-**-**----**-**-**-------**-------**----------**-
-*****-***********-*****-*****-**-*****-**-**-**-*****-*****-**************-*****-**-*****-********-**-*****-*****-**-********-**-*****-**-*****-
-**----**-**-------------------**-**-------**-**----**-------**----------**----**-**-**-------**-**----------**-**-**----**----**-**----**-**-**-
-**-**-**-********-*****************-*****-********-********-********-**-**-*****-**-**-**-*****-**-***********-*****-**-***********-********-**-
-**-**----**-**----------**-**----**----**----**-------**-------------**----------**----**----**-**----**----**-**-**-**-------**-**-**----**----
-***********-**-**-**-*****-**-*****************-**-**-********-*****-*****-*****-**-**-*****-**-***********-**-**-**-*****-*****-**-*****-**-**-
-**-------**----**-**-**----------**-**----------**-**-**----**----**-**-**----**-**-**-**-**-------------------------**-------**----**-------**-
-**-*****-********-**************-**-*****-**-**-********-***********-**-**-********-*****-********-*****-*****-********-*****-********-**-*****-
-**-**----**----**-------------**-------**-**-**----------**-------**----**-**----------**-**----------**----**----**-------**-------**-**-**----
-*****-**-**-********-**-*****-********-*****-***********-**-**-********-*****-**-********-**-********-**-********-*****************-**-**-*****-
-**-**-**-------**-**-**-**-**----**----------------**-------**----**----**----**-------**-**----**----**-**----**----------**-**----**-**-**----
-**-***********-**-**-**-**-**************-********-********-*****-********-**************-**************-**-***********-*****-*****-**-********-
-**-------**-**-------**-------**----------------**-------**-**-**-**-**-**-**-**----**----**----**----------**----**-**----**----**-**----**----
-********-**-*****-**-*****-********-*****-********-**-*****-**-**-**-**-**-**-*****-**-**-**-********-**-**-*****-**-*****-**-**-**-********-**-
----**----**-**----**-**----------**-**-------**-**-**----**-**-**-**----**-**-------**-**-------------**-**-**-------**-------**-**-**-**----**-
-********-**-*****-********-**-**-********-*****-*****-********-**-**-**-**-*****-********-***********-*****-**-***********************-**-*****-
----**----**-------**-**----**-**-**-**-------------**-------**-------**-**----**----------------**-**----**-**-------**-------**----**----**----
-********-**-*****-**-**-*****-*****-***********-**************-**-**-**************-*****-********-*****-*****-**-*****-*****-*****-**-*****-**-
-------**-------**-**-**-**----------------**----**-------**-**-**-**-**----**----------**----**-------**----**-**----**----**-------**----**-**-
-**-********-********-**-***********-**-*****-**-**-**-*****-*****-********-********-**-*****-*****-********-********-********-**-**-**-********-
-**----**-------**-------**-**-------**-**-**-**-**-**----**----**-**----**----**----**----**-**-------**-------------**-------**-**-------**----
-**-***********************-*****-********-**-********-*****-*****-*****-**-***********-**-**-*****-*****-********-*****-***********************-
-**-------**----------**-**----**-**----------------------------**----**----**-**-------**-**-**----------**-**-**----**-**-**-**----------**----
-**-*****************-**-**-*****-********-**-***********-**************-**-**-**-*****-**-***********-*****-**-********-**-**-********-**-*****-
-**-------------------------**-**----------**-**----**-**-------**-------**----------**-**-**-**----**-------------**-**-**----**-**----**-------
-********-*****-**-**-********-**-***********-**-*****-**-**-********-**************-**-*****-**-**-********-**-*****-*****-*****-*****-********-
----**----**----**-**----------**-**-------------**----**-**-------**----**----**----**-**----**-**-**-------**----**----------**----------**----
-***********-*****-*****-********-*****-**-********-**-***********-**-**-**-**-**************-*****-**-*****************-********-***********-**-
-**----**-**-**-**-**----------**-**----**----------**-**----**-------**----**-**-**-------**----------------**-------**-**----------------**-**-
-**-**-**-*****-**-**-*****-*****************-*****-********-********-*****-*****-********-*****************-*****-*****-********-**-********-**-
----**-**-**-**-**-**----**----**-------**----**-------**-------**-**-**----------------------------**----**----**-------**----**-**-**----**-**-
-**-**-**-**-**-**-***********-*****-**-**************-**-**-*****-*****-***********-*****-**************-*****-**-********-*****-**-**-********-
-**-**----**-**----**-**----**-**----**-**----------------**-**-------**-**-**-------**-**-**-------------**----**-**----**-**-**-**-**----**----
-*****-**-**-**-*****-*****-**-*****-**************************-***********-**-********-**-*****-********-**-*****-**-*****-**-**-**-**-********-
-**----**-**-**-------**----------**-**-------**----------**----**-**-------**-**-**-------**-------**----**-**-------**-**-**-**-**-**-**----**-
-*****-**-**-*****-***********-*****-**-*****-********-**-**-*****-********-**-**-*****-**-*****-**-**************-*****-**-**-********-*****-**-
----**-**----**-**-**-**-**-**----------**----**-**-**-**-**----------------**----**----**----**-**----**-------------**-------**-------**-**----
-**-********-**-*****-**-**-**-***********-*****-**-**-*****-**-***********-*****-**-*****-*****-********-**-*****-***********-**-**-**-**-**-**-
-**-**----**-**----**-------**----**----**-**----------------**-**-**-------**----**-**----------------**-**-**----**-**----------**-**-**----**-
-*****-**-*****-**-**-********-********-*****-*****-*****-********-**************-********************-***********-**-********-*****-********-**-
----**-**-------**-**-**-**-------**-**-------**-**-**----**-------**-------**-**-**----------**-------**-**-------------**-**----**-------**-**-
-********-*****-*****-**-*****-*****-**-**-*****-**************-*****-**-*****-**-*****-********-*****-**-**************-**-*****-**-***********-
-**-------**----------**-**-**----**-**-**-**----------**-**----**-**-**-**-**-------**----**-**-**-------**-------**----**----**-**-------**----
-*****-********-*****-**-**-********-**-**-**-********-**-**-*****-*****-**-*****-*****-*****-***********-**-*****-**-*****-*****-**-**-********-
-**-------**-**----**-**----**-**-**----**----**----**-**----------------**----------**-------------------------**----------**----**-**-**-**-**-
-***********-*****-*****-*****-**-*****-**-**-*****-**-**-*****-**-********-********-********-**-********-***********-*****-********-*****-**-**-
-**-------------------**----**----**----**-**----**----------**-**----**----**-**----------**-**----**-------------**-**-**-**-**-**-------**----
-*****-*****-********-**-*****-**-***********-***********-*****-*****-**-*****-**-********-**-***********-*****-********-**-**-**-**-**-**-*****-
----**-**-------**-------**----**-**-**-**----**----**----**----**-**-**----**----**-**-**-**-**----**----**----**----**-------**----**-**----**-
-***********-**-*****-***********-**-**-*****-**-**-**-*****-**-**-*****-*****-*****-**-**-********-***********-*****-**-*****-**-**-*****-**-**-
-**-**-**-**-**-**-**----------------------**----**-**----**-**-**----**-**-**-**-**----------------**-------**-**----**-**----**-**----**-**----
-**-**-**-**-*****-*****-**-********-********-**-**-**-**-*****-*****-**-**-*****-**-********-***********-**-*****-********-**-**-**-*****-*****-
----------**-**-**-**----**-**----**----**-**-**-**-**-**-**----------**-------**-**-**-**----------------**-------------**-**----**----**----**-
-**-**-********-**-*****-********-********-**-**-*****-********-**-*****-*****-**-**-**-**-*****-*****************-**-***********-***********-**-
-**-**----------**----**----**-**----------**-**-**-**-**-**----**-**-------**----**-**-**-**-------------**-------**----------**-------**----**-
-**-**-*****-**-*****-**-*****-**-*****-**-*****-**-*****-********-*****-**************-********************-**************-**-**-**-**-********-
-**-**----**-**-**-**----------**-**-**-**----------**-------**-------------**-**-------------------------**-------**-------**-**-**-**-**----**-
-*****-**-**-*****-**-**-***********-**-**************-**-********-*****-*****-*****-**-*****-********-*****-**************************-*****-**-
-**----**-**-**-**-**-**----**-------**----------**----**-**-**----**----**----**-**-**-**----**----**-**-------**-------------**-------**-------
-*****-*****-**-**-*****-*****-*****-**************-********-**-********-*****-**-***********-**-**-**-**-*****-**-**************-**************-
-**-------**----**----**----**----**-**-------------------------**-------------**-**-------**----**-**-**-**-**-**-------------**----**-------**-
-**-********-*****-*****-********-**-**************-**************-**-***********-**-*****-*****-********-**-*****-**-**-********************-**-
-**----**----**----------**-**----**----**-------**-**-**----**-**-**-**----**----------**-**----------**-**-**----**-**-**-**----**-------**----
-**-**-**-**************-**-**-***********-*****-**-**-*****-**-********-*****************-***********-*****-**-*****-*****-**-********-**-*****-
-**-**-**-**-**----------------------**-**-**----**----**-------**-------**-**----**-------**-------**-**-**-------**----**-------------**-**----
-***********-**-********-*****-*****-**-**-*****-**-********-***********-**-**-*****-*****-*****-*****-**-**-**-********-*****-*****-***********-
----**-**----**-------**-**----**----**----**----**-**-------------**-------**-------**-------**----**-------**----**-**-**----**----------**-**-
-*****-**-**-**-***********-**-*****-********-**-**-**-**-********-**-***********-**-**************-*****-***********-**-*****-********-*****-**-
----**----**----**-**-**----**----**----**----**-**-**-**----**----------**-**-**-**----**----**----**-------**-**-**-**----**-**-------**----**-
-*****************-**-**-********************-***********************-*****-**-********-*****-**-********-*****-**-**-*****************-**-*****-
----------------------------------------------------------------------------------------------------------------------------------------------**$