76 115
#**----------------------------------------------------------------------------------------------------------------
************-**-*****-**************************-**-*****-**************-*****-********-**-*****-*****-*****-*****-
-**-------**-**----**-**-------**-**-------**-**-**----**----**-**-------**-**-**-**----**----**-**-------**-**-**-
-**-********-*****-***********-**-**-********-***********-**-**-**-*****-**-*****-***********-***********-*****-**-
-**----**----**----------**-**-------------**----**-------**-**----**-------**----**----**-**----**-**-**-------**-
-*****-*****-**-*****-**-**-**-*****-********-********-********-********-********-**-**-**-**-**-**-**-**-********-
-------**----**-**-**-**----**----**----**----------**-**-**----**----**-**-**-**----**-------**-**----**-**-**----
-**-********-*****-**-**-*****-**-********-**-*****-*****-********-**-**-**-**-*****-*****-*****-**-*****-**-**-**-
-**-**-**-------**----**----**-**----**-**-**----**----**-------**-**----**-------**-**----**----------**----**-**-
-*****-**-**-**************-********-**-**-**-**************-**************-*****-********-**-*****-*****-**-*****-
-------**-**-------**-**----**-**-**-**----**----**-**----**----**----------**-------**-**-**----**----**-**-**----
-***********-*****-**-********-**-**-**-***********-**-********-**-***********-********-*****-**-*****-*****-**-**-
-**-------------**----**-**-**-**----**-------**----**----**----**-**-**----**----**----**-**-**-**-**-**-**-**-**-
-**-*****-********-*****-**-**-*****-**-*****-**-**-*****-*****-**-**-**-**************-**-********-*****-**-*****-
-**-**----**----**-**----------**-------**-------**-**-**----**-**-------------**----**-------**----**-**-**-**----
-*****-**-*****-**-*****-**-********-********-********-**-**-**-*****-**************-********-**-**-**-**-**-*****-
-**----**----**-**-------**-**----**-------**-**----**----**-**-**-------**-**-**----------------**----**-------**-
-**-**-**-**-**-*****-********-********-**-*****-**-**-**-*****-**-*****-**-**-**-********-*****-**-**************-
-**-**-**-**-**-------**-------**-------**-**-**-**----**-**----**-**-**----------**-**----**----**----**-**----**-
-**-*****-**-*****-**-**-*****-**-**-**-*****-**-********-**-**-*****-********-*****-***********-**-**-**-**-**-**-
-**-**----**----**-**-------**----**-**-------**-------**-**-**-**----------**-**----**----------**-**-**----**----
-**-**-**************-********-********-**-**-**-********-**-*****-**-********-*****-**-********-**-********-*****-
-**-**-**-------------**-**----**-**----**-**-**-**-**-------------**-------**-------**-------**-**----**----**----
-*****-*****-**-**-**-**-**-*****-***********-*****-*****-********-********-********-**-**-********-*****-*****-**-
-**-**-**-**-**-**-**-**----**----**----**-------**-------**-------**----**-**-------**-**-------**----**----**-**-
-**-**-**-***********-**-**-**-*****-*****-**-********-***********-**-**-**-*****-*****-**-**-**-********-********-
-**-**-**-------**----**-**----**----**-**-**----**-**----**-**----**-**-**-------**----**-**-**-------**----**----
-**-*****-***********-***********-*****-**-********-*****-**-*****-**-*****************-*****-********-**-*****-**-
-**-**----**-**-**-------**----**----------**----**----------**-**-**-**----**----**-------**-**----**-------**-**-
-**-*****-**-**-**-***********-**-**-**-********-***********-**-*****-**-********-**-********-**-**-**-*****-*****-
----**-**----------**----**-------**-**-**-**-------------**----**-------**-**----**-------**-**-**-**-**-**-**----
-**-**-***********-*****-********-**-*****-**-********-*****************-**-*****-*****************-*****-**-*****-
-**-**----------**-**----------**-**-**-------------**-**-**----**-**----**-------**-------**-------**----------**-
-**-********-***********-**-***********-**-********-*****-*****-**-*****-**-********-**-***********-*****-**-*****-
-**----------**-**-**-**-**----**-**-**-**----**-------**-------------------**-**----**----**-**----------**-**-**-
-**-**-********-**-**-**-********-**-********-*****-**-***********-*****-**-**-********-*****-*****-*****-*****-**-
-**-**----**-**----**----------**-**-**-**-**----**-**----**-**----**-**-**----**-**----------**-**----**-------**-
-***********-**-***********-**-**-**-**-**-**-**-*****-**-**-**-*****-*****-*****-********-**-**-*****************-
----**----------------**----**----**----------**----**-**----------**-------------**----**-**----**-**-------**----
-*****-**-*****-********-**-**************-***********-**-*****-********-*****-**-*****-**-*****-**-********-**-**-
----**-**----**----------**----**----------**----**-**-**-**-**-**-------**----**-**-------**----------**-------**-
-***********-********-********-*****-********-*****-*****-**-**-**-**************-**-**-***********-**-*****-*****-
-**----**----------**----**-------**-**----**-**----------**-**-**-**-**----**----**-**-------**-**-**-**-**-**-**-
-**-*****-********-***********-********-*****-*****-*****-**-*****-**-*****-***********-**-*****-**-*****-*****-**-
----**----**----**----**----------------**-------**----**-**----**----------**-------**-**-**-------------**-------
-**************-********************-**-*****-*****-**-*****-**-**-**-*****-*****-**-**-********-**-********-**-**-
-------------**-------**-------**----**-**-**----**-**-**----**----**-**-**----**-**-**----**----**-**----**-**-**-
-*****-**-*****-**-*****-***********-*****-*****-***********-*****-*****-*****-**-***********-********-**-********-
-**-**-**-**----**----------**----------**----**-------**----**----**-**-**-------**----------------**-**-------**-
-**-*****************-**-**-*****-*****-*****-**-***********-**-**-**-**-**-*****-*****-*****-********-***********-
-**-------**----**----**-**----------**-------**-------------**-**-------**----**----**-**-------**----**-**-**-**-
-*****-********-**-*****************-**-*****-*****-********-********-********************-**-**-*****-**-**-**-**-
-**----------**----------**-------**-**-**-------**-**-**-------**-------**-------**----**-**-**-------------**-**-
-***********-***********-********-********-*****-*****-*****-***********-**-***********-**-********-**-********-**-
----------**----------**----------------**-**-**-**----**----------**----**----------------**----**-**-**-------**-
-**-*****-********-**************-********-**-**-**-**-**-**-**************************-********-*****-**-********-
-**-**----------**-**----**-**----**-------**-------**----**-------**-**----**----------**-**-**-**----**----**-**-
-**-**-**-*****-**-*****-**-***********-*****-********-**-********-**-**-*****-********-**-**-**-**-**-**-*****-**-
-**-**-**----**-**-------**-**-------**----**-**-------**-**-------**-------**-**-**----**-**-------**-**-------**-
-***********-*****-*****-**-********-**-********-*****-**-**-*****-**-********-**-*****-**-*****-********-*****-**-
-**----------------**-**-**----**----**----**-**-**-**-**-**-**-**----**----**----**-**-**-------**----**-**----**-
-*****-***********-**-********-**-**-********-*****-**-*****-**-**-*****-**-**-*****-**-***********-***********-**-
----**----**----**-**----**-------**-**----**-------**-**-------**-------**----------**----**----------**-------**-
-********-**-**-**-*****-**-**-*****-*****-*****-********-********************-********************-**-*****-*****-
-------**----**-**----------**-**----**----------**----**----------------**----------**-**-**-------**-**----------
-***********-**-***********-*****-***********-*****-**-**-***********************-**-**-**-***********-*****-*****-
-------**----**-**-------**-**----**-------------**-**-**----**----**-------**-**-**----**----------**----------**-
-*****-***********-**-********-***********-*****-**-***********-**-**-**-*****-**-**-**-**-***********-********-**-
-**----**-------**-**-------**-**----**-**----**-**----------**-**-**-**----**----**-**-**-**----**----------**-**-
-********-*****-*****-*****-*****-**-**-*****-*****-********-**-*****-**-********-********-**-**-**-*****-**-*****-
-**-------**----**-**----**-------**----**----------------**-**----**-**----**----**----**----**-**-**----**----**-
-*****-*****-**-**-**-**-*****-*****-**-***********-*****-*****-**-**-*****-**-**-**-*****-**-**-**-*****-********-
----**-**----**----**-**----**-**----**----------**-**----**----**----**-------**-------**-**-**-**-**----**-**----
-********-********-***********************-**-********-**-*****-*****-********-*****-********-**************-**-**-
-**-**----------**----**-**----------**-**-**----**----**-**----**----**----**----**-**----**----**-**-------**-**-
-**-*****-**************-**-***********-*****-********-*****************-*****-***********-**-*****-**-***********-
----------------------------------------------------------------------------------------------------------------**$